"DATE/TIME","TYPE","ORDER#","BET#","REL. ORDER#","PRODUCT","VALUE DATE","STAKE","PRICE","BOUNDARY PRICE","STOP LOSS","TAKE PROFIT","MARGIN (GBP)","VALUE (GBP)","AMOUNT (GBP)","BALANCE (GBP)","AMOUNT EXCLUDING FEE","FEE","HOLDING COST - AMOUNT","HOLDING RATE","HOLDING COST (GBP)","HOLDING COST - OFFSET (GBP)","HOLDING COST - TOTAL (GBP)","PREMIUM","REFUND %","TARGET","WIN PAYOUT","DRAW PAYOUT","OPEN","EXPIRY","SETTLEMENT","SETTLEMENT PRICE","RESULT","PAYOUT","TYPE","EXPIRY","STRIKE PRICE","SETTLEMENT","SETTLEMENT PRICE","PROFIT","LOSS"
"11 Dec 2024 20:23:08","Close Bet","O2-DD-9DMMLN","T2-DD-5PN26R","O2-DD-9DMLRC","US NDAQ 100 - Cash","-","0.3","21,776.24","-","-","-","-","6,532.87","0.91","99,367.77","-","-","-","-","-","-","-","-","-","-","-","-","-","-","-","-","-","-","-","-","-","-","-","-","-"
"11 Dec 2024 20:23:08","Close Bet","O2-DD-9DMMLN","T2-DD-5PN26Q","O2-DD-9DMKTD","US NDAQ 100 - Cash","-","0.3","21,776.24","-","-","-","-","6,532.87","2.26","99,366.86","-","-","-","-","-","-","-","-","-","-","-","-","-","-","-","-","-","-","-","-","-","-","-","-","-"
"11 Dec 2024 19:49:13","Stop Loss","O2-DD-9DMFYN","T2-DD-5PN19E","-","US NDAQ 100 - Cash","-","0.3","21,755.01","-","-","-","-","6,526.50","-2.71","99,364.60","-","-","-","-","-","-","-","-","-","-","-","-","-","-","-","-","-","-","-","-","-","-","-","-","-"
"11 Dec 2024 19:38:48","Close Bet","O2-DD-9DMHJ3","T2-DD-5PN0ZK","O2-DD-9DM8YR","US NDAQ 100 - Dec 2024","-","0.3","21,807.13","-","-","-","-","6,542.13","-0.23","99,367.31","-","-","-","-","-","-","-","-","-","-","-","-","-","-","-","-","-","-","-","-","-","-","-","-","-"
"11 Dec 2024 18:26:23","Close Bet","O2-DD-9DM7RN","T2-DD-5PMY82","O2-DD-9DM7PN","Euro 50 - Cash","-","2","4,970.0","-","-","-","-","9,940.00","-3.20","99,367.54","-","-","-","-","-","-","-","-","-","-","-","-","-","-","-","-","-","-","-","-","-","-","-","-","-"
"11 Dec 2024 18:26:23","Close Bet","O2-DD-9DM7RN","T2-DD-5PMY81","O2-DD-9DM7NS","Euro 50 - Cash","-","1","4,970.0","-","-","-","-","4,970.00","-1.60","99,370.74","-","-","-","-","-","-","-","-","-","-","-","-","-","-","-","-","-","-","-","-","-","-","-","-","-"
"11 Dec 2024 18:25:19","Close Bet","O2-DD-9DM7MM","T2-DD-5PMY6Z","O2-DD-9DM7M6","Germany 40 - Cash","-","0.5","20,416.16","-","-","-","-","10,208.08","-2.03","99,372.34","-","-","-","-","-","-","-","-","-","-","-","-","-","-","-","-","-","-","-","-","-","-","-","-","-"
"11 Dec 2024 18:25:19","Close Bet","O2-DD-9DM7MM","T2-DD-5PMY6Y","O2-DD-9DM7KC","Germany 40 - Cash","-","0.5","20,416.16","-","-","-","-","10,208.08","-1.84","99,374.37","-","-","-","-","-","-","-","-","-","-","-","-","-","-","-","-","-","-","-","-","-","-","-","-","-"
"11 Dec 2024 17:47:46","Close Bet","O2-DD-9DM2W9","T2-DD-5PMWMR","O2-DD-9DLTEY","US NDAQ 100 - Cash","-","0.3","21,745.30","-","-","-","-","6,523.59","4.62","99,376.21","-","-","-","-","-","-","-","-","-","-","-","-","-","-","-","-","-","-","-","-","-","-","-","-","-"
"11 Dec 2024 17:15:33","Close Bet","O2-DD-9DLZDY","T2-DD-5PMV6M","O2-DD-9DLV5X","US 30 - Cash","-","0.2","44,274.03","-","-","-","-","8,854.80","-7.80","99,371.59","-","-","-","-","-","-","-","-","-","-","-","-","-","-","-","-","-","-","-","-","-","-","-","-","-"
"11 Dec 2024 17:09:26","Close Bet","O2-DD-9DLYSN","T2-DD-5PMTYJ","O2-DD-9DLWHB","Gasoline - Cash","-","1","1.9999","-","-","-","-","1,999.90","-3.70","99,379.39","-","-","-","-","-","-","-","-","-","-","-","-","-","-","-","-","-","-","-","-","-","-","-","-","-"
"11 Dec 2024 16:53:29","Close Bet","O2-DD-9DLWPB","T2-DD-5PMT21","O2-DD-9DLWCG","Euro 50 - Cash","-","0.6","4,959.0","-","-","-","-","2,975.40","-0.96","99,383.09","-","-","-","-","-","-","-","-","-","-","-","-","-","-","-","-","-","-","-","-","-","-","-","-","-"
"11 Dec 2024 16:53:14","Close Bet","O2-DD-9DLWMZ","T2-DD-5PMT1L","O2-DD-9DLWET","Germany 40 - Cash","-","0.1","20,392.42","-","-","-","-","2,039.24","-0.24","99,384.05","-","-","-","-","-","-","-","-","-","-","-","-","-","-","-","-","-","-","-","-","-","-","-","-","-"
"11 Dec 2024 16:36:50","Close Bet","O2-DD-9DLT01","T2-DD-5PMRW5","O2-DD-9DLSSW","US 30 - Cash","-","0.2","44,270.08","-","-","-","-","8,854.01","1.41","99,384.29","-","-","-","-","-","-","-","-","-","-","-","-","-","-","-","-","-","-","-","-","-","-","-","-","-"
"11 Dec 2024 16:36:10","Close Bet","O2-DD-9DLSWV","T2-DD-5PMRTZ","O2-DD-9DKX78","Gold - Cash","-","2","2,714.00","-","-","-","-","5,428.00","24.98","99,382.88","-","-","-","-","-","-","-","-","-","-","-","-","-","-","-","-","-","-","-","-","-","-","-","-","-"
"11 Dec 2024 16:31:17","Close Bet","O2-DD-9DLS6V","T2-DD-5PMRHW","O2-DD-9DLMST","Crude Oil West Texas - Cash","-","0.2","69.642","-","-","-","-","1,392.84","-0.50","99,357.90","-","-","-","-","-","-","-","-","-","-","-","-","-","-","-","-","-","-","-","-","-","-","-","-","-"
"11 Dec 2024 15:53:36","Close Bet","O2-DD-9DLKYF","T2-DD-5PMNWZ","O2-DD-9DKXS3","US NDAQ 100 - Cash","-","0.3","21,645.43","-","-","-","-","6,493.62","33.11","99,358.40","-","-","-","-","-","-","-","-","-","-","-","-","-","-","-","-","-","-","-","-","-","-","-","-","-"
"11 Dec 2024 15:30:34","Close Bet","O2-DD-9DLFBG","T2-DD-5PMM2W","O2-DD-9DJYSR","Heating Oil - Cash","-","1","2.2098","-","-","-","-","2,209.80","2.40","99,325.29","-","-","-","-","-","-","-","-","-","-","-","-","-","-","-","-","-","-","-","-","-","-","-","-","-"
"11 Dec 2024 14:51:38","Close Bet","O2-DD-9DL5MJ","T2-DD-5PMGR9","O2-DD-9DKNVN","US T-Note 10 YR - Cash","-","1","110.819","-","-","-","-","11,081.90","14.70","99,322.89","-","-","-","-","-","-","-","-","-","-","-","-","-","-","-","-","-","-","-","-","-","-","-","-","-"
"11 Dec 2024 14:51:25","Close Bet","O2-DD-9DL5L3","T2-DD-5PMGQM","O2-DD-9DL0MC","USD/JPY","-","1","152.151","-","-","-","-","15,215.10","-14.70","99,308.19","-","-","-","-","-","-","-","-","-","-","-","-","-","-","-","-","-","-","-","-","-","-","-","-","-"
"11 Dec 2024 14:43:49","Close Bet","O2-DD-9DL2YH","T2-DD-5PMFBC","O2-DD-9DKNKM","US 30 - Cash","-","0.3","44,303.54","-","-","-","-","13,291.06","-0.78","99,322.89","-","-","-","-","-","-","-","-","-","-","-","-","-","-","-","-","-","-","-","-","-","-","-","-","-"
"11 Dec 2024 14:40:40","Stop Loss","O2-DD-9DKYX2","T2-DD-5PMEZS","-","US 30 - Cash","-","0.1","44,291.41","-","-","-","-","4,429.14","-5.57","99,323.67","-","-","-","-","-","-","-","-","-","-","-","-","-","-","-","-","-","-","-","-","-","-","-","-","-"
"11 Dec 2024 12:21:54","Close Bet","O2-DD-9DKF94","T2-DD-5PM63S","O2-DD-9DGYCN","US T-Note 10 YR - Cash","-","1","110.554","-","-","-","-","11,055.40","-14.60","99,329.24","-","-","-","-","-","-","-","-","-","-","-","-","-","-","-","-","-","-","-","-","-","-","-","-","-"
"11 Dec 2024 12:19:47","Close Bet","O2-DD-9DKF0C","T2-DD-5PM61H","O2-DD-9DJZ2B","Japan 225 - Cash","-","0.5","39,715.94","-","-","-","-","19,857.97","40.21","99,343.84","-","-","-","-","-","-","-","-","-","-","-","-","-","-","-","-","-","-","-","-","-","-","-","-","-"
"11 Dec 2024 11:25:40","Close Bet","O2-DD-9DK7EP","T2-DD-5PM4JP","O2-DD-9DJZ7F","AUD/USD","-","1","0.63482","-","-","-","-","6,348.20","-10.90","99,303.63","-","-","-","-","-","-","-","-","-","-","-","-","-","-","-","-","-","-","-","-","-","-","-","-","-"
"11 Dec 2024 01:57:54","Close Bet","O2-DD-9DHP0C","T2-DD-5PLNH0","O2-DD-9DHGST","Japan 225 - Cash","-","0.5","39,217.44","-","-","-","-","19,608.72","28.75","99,314.53","-","-","-","-","-","-","-","-","-","-","-","-","-","-","-","-","-","-","-","-","-","-","-","-","-"
"11 Dec 2024 01:57:54","Close Bet","O2-DD-9DHP0C","T2-DD-5PLNGZ","O2-DD-9DHGSE","Japan 225 - Cash","-","0.5","39,217.44","-","-","-","-","19,608.72","26.24","99,285.78","-","-","-","-","-","-","-","-","-","-","-","-","-","-","-","-","-","-","-","-","-","-","-","-","-"
"11 Dec 2024 01:57:50","Close Bet","O2-DD-9DHP05","T2-DD-5PLNGW","O2-DD-9DHN2W","GBP/JPY","-","1.5","193.912","-","-","-","-","29,086.80","-2.40","99,259.54","-","-","-","-","-","-","-","-","-","-","-","-","-","-","-","-","-","-","-","-","-","-","-","-","-"
"11 Dec 2024 01:44:57","Close Bet","O2-DD-9DHMVG","T2-DD-5PLNBR","O2-DD-9DHFPN","GBP/JPY","-","1.5","193.942","-","-","-","-","29,091.30","-7.65","99,261.94","-","-","-","-","-","-","-","-","-","-","-","-","-","-","-","-","-","-","-","-","-","-","-","-","-"
"11 Dec 2024 01:04:42","Close Bet","O2-DD-9DHJJE","T2-DD-5PLMPV","O2-DD-9DHGS1","Japan 225 - Cash","-","0.5","39,307.46","-","-","-","-","19,653.73","-20.02","99,269.59","-","-","-","-","-","-","-","-","-","-","-","-","-","-","-","-","-","-","-","-","-","-","-","-","-"
"11 Dec 2024 00:38:25","Close Bet","O2-DD-9DHGFH","T2-DD-5PLM9F","O2-DD-9DHFZG","Japan 225 - Cash","-","0.5","39,337.27","-","-","-","-","19,668.63","-4.33","99,289.61","-","-","-","-","-","-","-","-","-","-","-","-","-","-","-","-","-","-","-","-","-","-","-","-","-"
"10 Dec 2024 20:49:20","Close Bet","O2-DD-9DH47T","T2-DD-5PLJJE","O2-DD-9DH0F0","Japan 225 - Cash","-","0.5","39,327.70","-","-","-","-","19,663.85","12.71","99,295.13","-","-","-","-","-","-","-","-","-","-","-","-","-","-","-","-","-","-","-","-","-","-","-","-","-"
"10 Dec 2024 20:49:20","Close Bet","O2-DD-9DH47T","T2-DD-5PLJJD","O2-DD-9DGZP7","Japan 225 - Cash","-","0.5","39,327.70","-","-","-","-","19,663.85","21.45","99,282.42","-","-","-","-","-","-","-","-","-","-","-","-","-","-","-","-","-","-","-","-","-","-","-","-","-"
"10 Dec 2024 20:49:16","Close Bet","O2-DD-9DH47F","T2-DD-5PLJJ8","O2-DD-9DH1KV","GBP/JPY","-","1.5","194.008","-","-","-","-","29,101.20","-4.80","99,260.97","-","-","-","-","-","-","-","-","-","-","-","-","-","-","-","-","-","-","-","-","-","-","-","-","-"
"10 Dec 2024 20:46:08","Close Bet","O2-DD-9DH3SM","T2-DD-5PLJE6","O2-DD-9DH1H5","Crude Oil West Texas - Cash","-","2.5","68.485","-","-","-","-","17,121.25","-2.50","99,265.77","-","-","-","-","-","-","-","-","-","-","-","-","-","-","-","-","-","-","-","-","-","-","-","-","-"
"10 Dec 2024 20:24:27","Close Bet","O2-DD-9DH1FC","T2-DD-5PLHHD","O2-DD-9DH0YX","GBP/JPY","-","1.5","194.041","-","-","-","-","29,106.15","-6.45","99,268.27","-","-","-","-","-","-","-","-","-","-","-","-","-","-","-","-","-","-","-","-","-","-","-","-","-"
"10 Dec 2024 20:11:20","Close Bet","O2-DD-9DH03X","T2-DD-5PLH36","O2-DD-9DH02H","US NDAQ 100 - Cash","-","1","21,339.81","-","-","-","-","21,339.81","4.08","99,274.72","-","-","-","-","-","-","-","-","-","-","-","-","-","-","-","-","-","-","-","-","-","-","-","-","-"
"10 Dec 2024 20:06:25","Close Bet","O2-DD-9DGZKM","T2-DD-5PLGX1","O2-DD-9DGYGR","Japan 225 - Cash","-","1","39,375.09","-","-","-","-","39,375.09","47.90","99,270.64","-","-","-","-","-","-","-","-","-","-","-","-","-","-","-","-","-","-","-","-","-","-","-","-","-"
"10 Dec 2024 20:06:04","Close Bet","O2-DD-9DGZJ6","T2-DD-5PLGWJ","O2-DD-9DGYGR","Japan 225 - Cash","-","0.5","39,380.08","-","-","-","-","19,690.04","21.46","99,222.74","-","-","-","-","-","-","-","-","-","-","-","-","-","-","-","-","-","-","-","-","-","-","-","-","-"
"10 Dec 2024 20:02:42","Close Bet","O2-DD-9DGZ2B","T2-DD-5PLGMT","O2-DD-9DGYWB","US NDAQ 100 - Cash","-","1","21,355.75","-","-","-","-","21,355.75","9.03","99,201.28","-","-","-","-","-","-","-","-","-","-","-","-","-","-","-","-","-","-","-","-","-","-","-","-","-"
"10 Dec 2024 19:57:33","Close Bet","O2-DD-9DGYH2","T2-DD-5PLGFG","O2-DD-9DGWF1","US NDAQ 100 - Cash","-","1","21,373.26","-","-","-","-","21,373.26","10.22","99,192.25","-","-","-","-","-","-","-","-","-","-","-","-","-","-","-","-","-","-","-","-","-","-","-","-","-"
"10 Dec 2024 19:35:13","Close Bet","O2-DD-9DGVZB","T2-DD-5PLFJM","O2-DD-9DGQ2F","US NDAQ 100 - Cash","-","1","21,398.69","-","-","-","-","21,398.69","20.82","99,182.03","-","-","-","-","-","-","-","-","-","-","-","-","-","-","-","-","-","-","-","-","-","-","-","-","-"
"10 Dec 2024 19:35:10","Close Bet","O2-DD-9DGVZ5","T2-DD-5PLFJK","O2-DD-9DGQ61","USD/JPY","-","1","151.936","-","-","-","-","15,193.60","-5.40","99,161.21","-","-","-","-","-","-","-","-","-","-","-","-","-","-","-","-","-","-","-","-","-","-","-","-","-"
"10 Dec 2024 19:34:01","Close Bet","O2-DD-9DGVVP","T2-DD-5PLFHQ","O2-DD-9DGL7J","Crude Oil West Texas - Cash","-","0.5","68.675","-","-","-","-","3,433.75","8.75","99,166.61","-","-","-","-","-","-","-","-","-","-","-","-","-","-","-","-","-","-","-","-","-","-","-","-","-"
"10 Dec 2024 17:32:05","Close Bet","O2-DD-9DGERZ","T2-DD-5PLBW2","O2-DD-9DGEDY","Japan 225 - Cash","-","1.5","39,462.84","-","-","-","-","59,194.26","11.97","99,157.86","-","-","-","-","-","-","-","-","-","-","-","-","-","-","-","-","-","-","-","-","-","-","-","-","-"
"10 Dec 2024 17:04:36","Close Bet","O2-DD-9DGBR3","T2-DD-5PL9VY","O2-DD-9DG4VY","Japan 225 - Cash","-","1.5","39,444.87","-","-","-","-","59,167.30","-40.49","99,145.89","-","-","-","-","-","-","-","-","-","-","-","-","-","-","-","-","-","-","-","-","-","-","-","-","-"
"10 Dec 2024 17:03:48","Close Bet","O2-DD-9DGBMY","T2-DD-5PL9TW","O2-DD-9DG5BF","Crude Oil West Texas - Cash","-","1","68.971","-","-","-","-","6,897.10","-16.00","99,186.38","-","-","-","-","-","-","-","-","-","-","-","-","-","-","-","-","-","-","-","-","-","-","-","-","-"
"10 Dec 2024 16:14:10","Close Bet","O2-DD-9DG4ZR","T2-DD-5PL7CN","O2-DD-9DG137","Crude Oil West Texas - Cash","-","1","69.071","-","-","-","-","6,907.10","28.60","99,202.38","-","-","-","-","-","-","-","-","-","-","-","-","-","-","-","-","-","-","-","-","-","-","-","-","-"
"10 Dec 2024 16:08:06","Stop Loss","O2-DD-9DG18J","T2-DD-5PL6SR","-","Japan 225 - Cash","-","1.5","39,418.59","-","-","-","-","59,127.88","-61.82","99,173.78","-","-","-","-","-","-","-","-","-","-","-","-","-","-","-","-","-","-","-","-","-","-","-","-","-"
"10 Dec 2024 15:38:18","Close Bet","O2-DD-9DG0T0","T2-DD-5PL4PC","O2-DD-9DFZYS","Crude Oil West Texas - Cash","-","1","68.720","-","-","-","-","6,872.00","15.50","99,235.60","-","-","-","-","-","-","-","-","-","-","-","-","-","-","-","-","-","-","-","-","-","-","-","-","-"
"10 Dec 2024 15:34:34","Close Bet","O2-DD-9DG0CT","T2-DD-5PL4FB","O2-DD-9DFYXP","Japan 225 - Cash","-","1.5","39,444.82","-","-","-","-","59,167.23","-32.97","99,220.10","-","-","-","-","-","-","-","-","-","-","-","-","-","-","-","-","-","-","-","-","-","-","-","-","-"
"10 Dec 2024 15:31:56","Stop Loss","O2-DD-9DFNT5","T2-DD-5PL47F","-","US T-Note 10 YR - Cash","-","1","110.573","-","-","-","-","11,057.30","-14.30","99,253.07","-","-","-","-","-","-","-","-","-","-","-","-","-","-","-","-","-","-","-","-","-","-","-","-","-"
"10 Dec 2024 15:21:46","Close Bet","O2-DD-9DFZ41","T2-DD-5PL3FD","O2-DD-9DFXSG","GBP/JPY","-","1.5","193.473","-","-","-","-","29,020.95","-17.85","99,267.37","-","-","-","-","-","-","-","-","-","-","-","-","-","-","-","-","-","-","-","-","-","-","-","-","-"
"10 Dec 2024 15:19:00","Close Bet","O2-DD-9DFYTV","T2-DD-5PL37X","O2-DD-9DFYRN","US NDAQ 100 - Cash","-","5","21,563.96","-","-","-","-","107,819.80","10.60","99,285.22","-","-","-","-","-","-","-","-","-","-","-","-","-","-","-","-","-","-","-","-","-","-","-","-","-"
"10 Dec 2024 15:17:43","Close Bet","O2-DD-9DFYNT","T2-DD-5PL35Q","O2-DD-9DFYD7","US NDAQ 100 - Cash","-","2","21,558.29","-","-","-","-","43,116.58","-3.14","99,274.62","-","-","-","-","-","-","-","-","-","-","-","-","-","-","-","-","-","-","-","-","-","-","-","-","-"
"10 Dec 2024 15:15:09","Close Bet","O2-DD-9DFYBZ","T2-DD-5PL30V","O2-DD-9DFY13","Japan 225 - Cash","-","1.5","39,454.79","-","-","-","-","59,182.18","-62.91","99,277.76","-","-","-","-","-","-","-","-","-","-","-","-","-","-","-","-","-","-","-","-","-","-","-","-","-"
"10 Dec 2024 15:14:23","Close Bet","O2-DD-9DFY7Q","T2-DD-5PL2YT","O2-DD-9DFXBX","Crude Oil West Texas - Cash","-","1","68.585","-","-","-","-","6,858.50","1.50","99,340.67","-","-","-","-","-","-","-","-","-","-","-","-","-","-","-","-","-","-","-","-","-","-","-","-","-"
"10 Dec 2024 15:08:40","Close Bet","O2-DD-9DFXG7","T2-DD-5PL2FD","O2-DD-9DFX4W","US NDAQ 100 - Cash","-","2","21,554.80","-","-","-","-","43,109.60","27.08","99,339.17","-","-","-","-","-","-","-","-","-","-","-","-","-","-","-","-","-","-","-","-","-","-","-","-","-"
"10 Dec 2024 15:06:55","Close Bet","O2-DD-9DFXB6","T2-DD-5PL29Z","O2-DD-9DFX63","GBP/JPY","-","1.5","193.430","-","-","-","-","29,014.50","-16.35","99,312.09","-","-","-","-","-","-","-","-","-","-","-","-","-","-","-","-","-","-","-","-","-","-","-","-","-"
"10 Dec 2024 15:04:05","Close Bet","O2-DD-9DFX00","T2-DD-5PL22E","O2-DD-9DFVZJ","GBP/JPY","-","0.5","193.348","-","-","-","-","9,667.40","4.15","99,328.44","-","-","-","-","-","-","-","-","-","-","-","-","-","-","-","-","-","-","-","-","-","-","-","-","-"
"10 Dec 2024 15:04:05","Close Bet","O2-DD-9DFX00","T2-DD-5PL22D","O2-DD-9DFVYT","GBP/JPY","-","0.5","193.348","-","-","-","-","9,667.40","4.20","99,324.29","-","-","-","-","-","-","-","-","-","-","-","-","-","-","-","-","-","-","-","-","-","-","-","-","-"
"10 Dec 2024 15:03:58","Close Bet","O2-DD-9DFWZF","T2-DD-5PL216","O2-DD-9DFWNV","US NDAQ 100 - Cash","-","0.5","21,527.69","-","-","-","-","10,763.84","0.64","99,320.09","-","-","-","-","-","-","-","-","-","-","-","-","-","-","-","-","-","-","-","-","-","-","-","-","-"
"10 Dec 2024 15:02:58","Close Bet","O2-DD-9DFWT8","T2-DD-5PL1Y4","O2-DD-9DFWLD","Japan 225 - Cash","-","1.5","39,439.81","-","-","-","-","59,159.71","-40.44","99,319.45","-","-","-","-","-","-","-","-","-","-","-","-","-","-","-","-","-","-","-","-","-","-","-","-","-"
"10 Dec 2024 15:00:59","Close Bet","O2-DD-9DFWJZ","T2-DD-5PL1QD","O2-DD-9DFWH3","US NDAQ 100 - Cash","-","0.5","21,512.36","-","-","-","-","10,756.18","0.31","99,359.89","-","-","-","-","-","-","-","-","-","-","-","-","-","-","-","-","-","-","-","-","-","-","-","-","-"
"10 Dec 2024 15:00:26","Close Bet","O2-DD-9DFWFN","T2-DD-5PL1NF","O2-DD-9DFTQ9","Japan 225 - Cash","-","1.5","39,429.83","-","-","-","-","59,144.74","0.72","99,359.58","-","-","-","-","-","-","-","-","-","-","-","-","-","-","-","-","-","-","-","-","-","-","-","-","-"
"10 Dec 2024 14:54:28","Close Bet","O2-DD-9DFVK3","T2-DD-5PL11S","O2-DD-9DFTFQ","Crude Oil West Texas - Cash","-","1","68.460","-","-","-","-","6,846.00","-14.50","99,358.86","-","-","-","-","-","-","-","-","-","-","-","-","-","-","-","-","-","-","-","-","-","-","-","-","-"
"10 Dec 2024 14:45:57","Close Bet","O2-DD-9DFT87","T2-DD-5PL06M","O2-DD-9DFSZ7","Japan 225 - Cash","-","1.5","39,467.25","-","-","-","-","59,200.87","-25.47","99,373.36","-","-","-","-","-","-","-","-","-","-","-","-","-","-","-","-","-","-","-","-","-","-","-","-","-"
"10 Dec 2024 14:45:31","Close Bet","O2-DD-9DFT6B","T2-DD-5PL04W","O2-DD-9DFSB7","Japan 225 - Cash","-","1.5","39,469.75","-","-","-","-","59,204.62","-85.37","99,398.83","-","-","-","-","-","-","-","-","-","-","-","-","-","-","-","-","-","-","-","-","-","-","-","-","-"
"10 Dec 2024 14:45:26","Close Bet","O2-DD-9DFT63","T2-DD-5PL04R","O2-DD-9DFSNT","US NDAQ 100 - Cash","-","0.5","21,547.99","-","-","-","-","10,773.99","14.13","99,484.20","-","-","-","-","-","-","-","-","-","-","-","-","-","-","-","-","-","-","-","-","-","-","-","-","-"
"10 Dec 2024 14:42:32","Close Bet","O2-DD-9DFSKC","T2-DD-5PKZMD","O2-DD-9DFSEK","US NDAQ 100 - Cash","-","2","21,520.21","-","-","-","-","43,040.42","11.26","99,470.07","-","-","-","-","-","-","-","-","-","-","-","-","-","-","-","-","-","-","-","-","-","-","-","-","-"
"10 Dec 2024 14:42:16","Close Bet","O2-DD-9DFSJ0","T2-DD-5PKZL3","O2-DD-9DFS6V","US NDAQ 100 - Cash","-","2","21,515.08","-","-","-","-","43,030.16","9.24","99,458.81","-","-","-","-","-","-","-","-","-","-","-","-","-","-","-","-","-","-","-","-","-","-","-","-","-"
"10 Dec 2024 14:40:11","Close Bet","O2-DD-9DFS4P","T2-DD-5PKZBE","O2-DD-9DFS3L","US NDAQ 100 - Cash","-","2","21,510.59","-","-","-","-","43,021.18","13.28","99,449.57","-","-","-","-","-","-","-","-","-","-","-","-","-","-","-","-","-","-","-","-","-","-","-","-","-"
"10 Dec 2024 14:39:46","Close Bet","O2-DD-9DFS21","T2-DD-5PKZ7Z","O2-DD-9DFMT6","Gold - Cash","-","2","2,687.50","-","-","-","-","5,375.00","16.50","99,436.29","-","-","-","-","-","-","-","-","-","-","-","-","-","-","-","-","-","-","-","-","-","-","-","-","-"
"10 Dec 2024 14:38:41","Close Bet","O2-DD-9DFRXN","T2-DD-5PKZ4T","O2-DD-9DFRNQ","US NDAQ 100 - Cash","-","2","21,490.11","-","-","-","-","42,980.22","-8.40","99,419.79","-","-","-","-","-","-","-","-","-","-","-","-","-","-","-","-","-","-","-","-","-","-","-","-","-"
"10 Dec 2024 14:38:02","Close Bet","O2-DD-9DFRTH","T2-DD-5PKZ2C","O2-DD-9DFRJ9","Japan 225 - Cash","-","0.5","39,449.78","-","-","-","-","19,724.89","-10.99","99,428.19","-","-","-","-","-","-","-","-","-","-","-","-","-","-","-","-","-","-","-","-","-","-","-","-","-"
"10 Dec 2024 14:22:05","Close Bet","O2-DD-9DFPNM","T2-DD-5PKXHG","O2-DD-9DF9QH","USD/CAD","-","0.5","1.41679","-","-","-","-","7,083.95","-0.50","99,439.18","-","-","-","-","-","-","-","-","-","-","-","-","-","-","-","-","-","-","-","-","-","-","-","-","-"
"10 Dec 2024 14:11:52","Close Bet","O2-DD-9DFP8B","T2-DD-5PKX6L","O2-DD-9DFERH","Crude Oil West Texas - Cash","-","0.5","68.568","-","-","-","-","3,428.40","15.05","99,439.68","-","-","-","-","-","-","-","-","-","-","-","-","-","-","-","-","-","-","-","-","-","-","-","-","-"
"10 Dec 2024 14:10:09","Close Bet","O2-DD-9DFP47","T2-DD-5PKX3V","O2-DD-9DFNFT","GBP/JPY","-","0.5","193.540","-","-","-","-","9,677.00","-11.00","99,424.63","-","-","-","-","-","-","-","-","-","-","-","-","-","-","-","-","-","-","-","-","-","-","-","-","-"
"10 Dec 2024 14:10:07","Stop Loss","O2-DD-9DFM5D","T2-DD-5PKX3L","-","US NDAQ 100 - Cash","-","2","21,480.97","-","-","-","-","42,961.94","-17.08","99,435.63","-","-","-","-","-","-","-","-","-","-","-","-","-","-","-","-","-","-","-","-","-","-","-","-","-"
"10 Dec 2024 13:34:14","Close Bet","O2-DD-9DFLS4","T2-DD-5PKVMV","O2-DD-9DFKRG","Japan 225 - Cash","-","0.2","39,414.81","-","-","-","-","7,882.96","2.59","99,452.71","-","-","-","-","-","-","-","-","-","-","-","-","-","-","-","-","-","-","-","-","-","-","-","-","-"
"10 Dec 2024 13:01:24","Close Bet","O2-DD-9DFJNX","T2-DD-5PKT5N","O2-DD-9DF9DR","GBP/JPY","-","0.5","193.554","-","-","-","-","9,677.70","-2.50","99,450.12","-","-","-","-","-","-","-","-","-","-","-","-","-","-","-","-","-","-","-","-","-","-","-","-","-"
"10 Dec 2024 13:00:56","Close Bet","O2-DD-9DFJMV","T2-DD-5PKT4W","O2-DD-9DFEGV","Gold - Cash","-","3","2,675.73","-","-","-","-","8,027.19","-3.12","99,452.62","-","-","-","-","-","-","-","-","-","-","-","-","-","-","-","-","-","-","-","-","-","-","-","-","-"
"10 Dec 2024 08:29:53","Close Bet","O2-DD-9DEV2V","T2-DD-5PKJL7","O2-DD-9DEE2D","Japan 225 - Cash","-","1","39,380.11","-","-","-","-","39,380.11","126.04","99,455.74","-","-","-","-","-","-","-","-","-","-","-","-","-","-","-","-","-","-","-","-","-","-","-","-","-"
"10 Dec 2024 08:15:18","Stop Loss","O2-DD-9DC7W7","T2-DD-5PKHVF","-","Gold - Cash","-","2","2,661.75","-","-","-","-","5,323.50","36.46","99,329.70","-","-","-","-","-","-","-","-","-","-","-","-","-","-","-","-","-","-","-","-","-","-","-","-","-"
"10 Dec 2024 02:54:30","Stop Loss","O2-DD-9DEBJB","T2-DD-5PK91F","-","Crude Oil West Texas - Cash","-","0.3","68.139","-","-","-","-","2,044.17","-6.39","99,293.24","-","-","-","-","-","-","-","-","-","-","-","-","-","-","-","-","-","-","-","-","-","-","-","-","-"
"10 Dec 2024 02:43:31","Close Bet","O2-DD-9DECN1","T2-DD-5PK8WP","O2-DD-9DEC9M","Japan 225 - Cash","-","1.5","39,217.10","-","-","-","-","58,825.65","-21.72","99,299.63","-","-","-","-","-","-","-","-","-","-","-","-","-","-","-","-","-","-","-","-","-","-","-","-","-"
"10 Dec 2024 02:32:15","Close Bet","O2-DD-9DEC9B","T2-DD-5PK8Q7","O2-DD-9DEC87","Japan 225 - Cash","-","0.5","39,214.60","-","-","-","-","19,607.30","-1.01","99,321.35","-","-","-","-","-","-","-","-","-","-","-","-","-","-","-","-","-","-","-","-","-","-","-","-","-"
"10 Dec 2024 02:32:15","Close Bet","O2-DD-9DEC9B","T2-DD-5PK8Q6","O2-DD-9DEC82","Japan 225 - Cash","-","0.5","39,214.60","-","-","-","-","19,607.30","-1.01","99,322.36","-","-","-","-","-","-","-","-","-","-","-","-","-","-","-","-","-","-","-","-","-","-","-","-","-"
"10 Dec 2024 02:32:15","Close Bet","O2-DD-9DEC9B","T2-DD-5PK8Q5","O2-DD-9DEC7Y","Japan 225 - Cash","-","0.5","39,214.60","-","-","-","-","19,607.30","-1.01","99,323.37","-","-","-","-","-","-","-","-","-","-","-","-","-","-","-","-","-","-","-","-","-","-","-","-","-"
"10 Dec 2024 02:30:14","Close Bet","O2-DD-9DEC7N","T2-DD-5PK8PE","O2-DD-9DEBVP","Japan 225 - Cash","-","0.5","39,216.61","-","-","-","-","19,608.30","-9.79","99,324.38","-","-","-","-","-","-","-","-","-","-","-","-","-","-","-","-","-","-","-","-","-","-","-","-","-"
"10 Dec 2024 02:26:02","Close Bet","O2-DD-9DEC2P","T2-DD-5PK8KW","O2-DD-9DEBZ9","Japan 225 - Cash","-","0.5","39,201.70","-","-","-","-","19,600.85","-2.29","99,334.17","-","-","-","-","-","-","-","-","-","-","-","-","-","-","-","-","-","-","-","-","-","-","-","-","-"
"10 Dec 2024 02:12:38","Close Bet","O2-DD-9DEBRZ","T2-DD-5PK8D5","O2-DD-9DD021","GBP/JPY","-","0.5","192.721","-","-","-","-","9,636.05","24.35","99,336.46","-","-","-","-","-","-","-","-","-","-","-","-","-","-","-","-","-","-","-","-","-","-","-","-","-"
"10 Dec 2024 01:42:14","Close Bet","O2-DD-9DE8KW","T2-DD-5PK7JC","O2-DD-9DE8H0","Japan 225 - Cash","-","0.5","39,181.42","-","-","-","-","19,590.71","2.60","99,312.11","-","-","-","-","-","-","-","-","-","-","-","-","-","-","-","-","-","-","-","-","-","-","-","-","-"
"10 Dec 2024 01:38:46","Close Bet","O2-DD-9DE8DX","T2-DD-5PK7CF","O2-DD-9DE77W","Crude Oil West Texas - Cash","-","0.3","68.302","-","-","-","-","2,049.06","-3.15","99,309.51","-","-","-","-","-","-","-","-","-","-","-","-","-","-","-","-","-","-","-","-","-","-","-","-","-"
"10 Dec 2024 01:21:11","Close Bet","O2-DD-9DE7NT","T2-DD-5PK6RH","O2-DD-9DE7FW","Japan 225 - Cash","-","0.5","39,352.35","-","-","-","-","19,676.17","18.39","99,312.66","-","-","-","-","-","-","-","-","-","-","-","-","-","-","-","-","-","-","-","-","-","-","-","-","-"
"10 Dec 2024 01:11:54","Close Bet","O2-DD-9DE7EP","T2-DD-5PK6K6","O2-DD-9DE7EJ","Japan 225 - Cash","-","0.5","39,300.45","-","-","-","-","19,650.22","-1.05","99,294.27","-","-","-","-","-","-","-","-","-","-","-","-","-","-","-","-","-","-","-","-","-","-","-","-","-"
"10 Dec 2024 01:11:17","Close Bet","O2-DD-9DE7EE","T2-DD-5PK6JZ","O2-DD-9DE78G","Japan 225 - Cash","-","0.5","39,298.29","-","-","-","-","19,649.14","-18.19","99,295.32","-","-","-","-","-","-","-","-","-","-","-","-","-","-","-","-","-","-","-","-","-","-","-","-","-"
"10 Dec 2024 01:03:17","Close Bet","O2-DD-9DE779","T2-DD-5PK6F9","O2-DD-9DDNBJ","US NDAQ 100 - Cash","-","0.5","21,441.61","-","-","-","-","10,720.80","7.33","99,313.51","-","-","-","-","-","-","-","-","-","-","-","-","-","-","-","-","-","-","-","-","-","-","-","-","-"
"10 Dec 2024 01:03:08","Close Bet","O2-DD-9DE775","T2-DD-5PK6F5","O2-DD-9DE70B","Japan 225 - Cash","-","0.5","39,312.35","-","-","-","-","19,656.17","-0.71","99,306.18","-","-","-","-","-","-","-","-","-","-","-","-","-","-","-","-","-","-","-","-","-","-","-","-","-"
"10 Dec 2024 00:58:53","Close Bet","O2-DD-9DE6Z8","T2-DD-5PK6BJ","O2-DD-9DE6VF","Japan 225 - Cash","-","1","39,306.61","-","-","-","-","39,306.61","30.77","99,306.89","-","-","-","-","-","-","-","-","-","-","-","-","-","-","-","-","-","-","-","-","-","-","-","-","-"
"10 Dec 2024 00:58:53","Close Bet","O2-DD-9DE6Z8","T2-DD-5PK6BH","O2-DD-9DE6V3","Japan 225 - Cash","-","1","39,306.61","-","-","-","-","39,306.61","20.84","99,276.12","-","-","-","-","-","-","-","-","-","-","-","-","-","-","-","-","-","-","-","-","-","-","-","-","-"
"10 Dec 2024 00:55:46","Close Bet","O2-DD-9DE6TX","T2-DD-5PK687","O2-DD-9DE6R7","Japan 225 - Cash","-","0.3","39,261.29","-","-","-","-","11,778.38","-3.58","99,255.28","-","-","-","-","-","-","-","-","-","-","-","-","-","-","-","-","-","-","-","-","-","-","-","-","-"
"10 Dec 2024 00:55:24","Close Bet","O2-DD-9DE6TD","T2-DD-5PK680","O2-DD-9DE6R7","Japan 225 - Cash","-","0.7","39,261.23","-","-","-","-","27,482.86","-8.39","99,258.86","-","-","-","-","-","-","-","-","-","-","-","-","-","-","-","-","-","-","-","-","-","-","-","-","-"
"10 Dec 2024 00:55:24","Close Bet","O2-DD-9DE6TD","T2-DD-5PK67Z","O2-DD-9DE6QP","Japan 225 - Cash","-","0.3","39,261.23","-","-","-","-","11,778.36","-5.15","99,267.25","-","-","-","-","-","-","-","-","-","-","-","-","-","-","-","-","-","-","-","-","-","-","-","-","-"
"10 Dec 2024 00:51:54","Close Bet","O2-DD-9DE6QZ","T2-DD-5PK66K","O2-DD-9DE6QP","Japan 225 - Cash","-","0.7","39,251.33","-","-","-","-","27,475.93","-18.94","99,272.40","-","-","-","-","-","-","-","-","-","-","-","-","-","-","-","-","-","-","-","-","-","-","-","-","-"
"10 Dec 2024 00:51:54","Close Bet","O2-DD-9DE6QZ","T2-DD-5PK66J","O2-DD-9DE6Q6","Japan 225 - Cash","-","0.3","39,251.33","-","-","-","-","11,775.39","-8.14","99,291.34","-","-","-","-","-","-","-","-","-","-","-","-","-","-","-","-","-","-","-","-","-","-","-","-","-"
"10 Dec 2024 00:50:31","Close Bet","O2-DD-9DE6Q6","T2-DD-5PK660","O2-DD-9DE6NF","Japan 225 - Cash","-","0.2","39,278.46","-","-","-","-","7,855.69","-5.31","99,299.48","-","-","-","-","-","-","-","-","-","-","-","-","-","-","-","-","-","-","-","-","-","-","-","-","-"
"10 Dec 2024 00:50:18","Close Bet","O2-DD-9DE6PY","T2-DD-5PK65X","O2-DD-9DE6NF","Japan 225 - Cash","-","0.3","39,273.46","-","-","-","-","11,782.03","-6.47","99,304.79","-","-","-","-","-","-","-","-","-","-","-","-","-","-","-","-","-","-","-","-","-","-","-","-","-"
"10 Dec 2024 00:50:18","Close Bet","O2-DD-9DE6PY","T2-DD-5PK65W","O2-DD-9DE6MZ","Japan 225 - Cash","-","0.2","39,273.46","-","-","-","-","7,854.69","-3.31","99,311.26","-","-","-","-","-","-","-","-","-","-","-","-","-","-","-","-","-","-","-","-","-","-","-","-","-"
"10 Dec 2024 00:50:08","Close Bet","O2-DD-9DE6PQ","T2-DD-5PK65Q","O2-DD-9DE6MZ","Japan 225 - Cash","-","0.3","39,278.46","-","-","-","-","11,783.53","-6.46","99,314.57","-","-","-","-","-","-","-","-","-","-","-","-","-","-","-","-","-","-","-","-","-","-","-","-","-"
"10 Dec 2024 00:50:08","Close Bet","O2-DD-9DE6PQ","T2-DD-5PK65P","O2-DD-9DE6MJ","Japan 225 - Cash","-","0.2","39,278.46","-","-","-","-","7,855.69","-4.80","99,321.03","-","-","-","-","-","-","-","-","-","-","-","-","-","-","-","-","-","-","-","-","-","-","-","-","-"
"10 Dec 2024 00:49:46","Close Bet","O2-DD-9DE6PE","T2-DD-5PK659","O2-DD-9DE6MJ","Japan 225 - Cash","-","0.3","39,263.60","-","-","-","-","11,779.08","-2.75","99,325.83","-","-","-","-","-","-","-","-","-","-","-","-","-","-","-","-","-","-","-","-","-","-","-","-","-"
"10 Dec 2024 00:49:46","Close Bet","O2-DD-9DE6PE","T2-DD-5PK658","O2-DD-9DE6LD","Japan 225 - Cash","-","0.2","39,263.60","-","-","-","-","7,852.72","-1.25","99,328.58","-","-","-","-","-","-","-","-","-","-","-","-","-","-","-","-","-","-","-","-","-","-","-","-","-"
"10 Dec 2024 00:47:19","Close Bet","O2-DD-9DE6MF","T2-DD-5PK63Z","O2-DD-9DE6LD","Japan 225 - Cash","-","0.3","39,273.95","-","-","-","-","11,782.18","-4.99","99,329.83","-","-","-","-","-","-","-","-","-","-","-","-","-","-","-","-","-","-","-","-","-","-","-","-","-"
"10 Dec 2024 00:47:19","Close Bet","O2-DD-9DE6MF","T2-DD-5PK63Y","O2-DD-9DE6KR","Japan 225 - Cash","-","0.2","39,273.95","-","-","-","-","7,854.79","-3.30","99,334.82","-","-","-","-","-","-","-","-","-","-","-","-","-","-","-","-","-","-","-","-","-","-","-","-","-"
"10 Dec 2024 00:47:11","Close Bet","O2-DD-9DE6M4","T2-DD-5PK63S","O2-DD-9DE6KR","Japan 225 - Cash","-","0.3","39,274.00","-","-","-","-","11,782.20","-4.96","99,338.12","-","-","-","-","-","-","-","-","-","-","-","-","-","-","-","-","-","-","-","-","-","-","-","-","-"
"10 Dec 2024 00:47:11","Close Bet","O2-DD-9DE6M4","T2-DD-5PK63R","O2-DD-9DE6K0","Japan 225 - Cash","-","0.2","39,274.00","-","-","-","-","7,854.80","-3.28","99,343.08","-","-","-","-","-","-","-","-","-","-","-","-","-","-","-","-","-","-","-","-","-","-","-","-","-"
"10 Dec 2024 00:45:51","Close Bet","O2-DD-9DE6L4","T2-DD-5PK63C","O2-DD-9DE6K0","Japan 225 - Cash","-","0.3","39,279.34","-","-","-","-","11,783.80","-6.52","99,346.36","-","-","-","-","-","-","-","-","-","-","-","-","-","-","-","-","-","-","-","-","-","-","-","-","-"
"10 Dec 2024 00:45:51","Close Bet","O2-DD-9DE6L4","T2-DD-5PK63B","O2-DD-9DE6JS","Japan 225 - Cash","-","0.2","39,279.34","-","-","-","-","7,855.86","-2.83","99,352.88","-","-","-","-","-","-","-","-","-","-","-","-","-","-","-","-","-","-","-","-","-","-","-","-","-"
"10 Dec 2024 00:43:15","Close Bet","O2-DD-9DE6HQ","T2-DD-5PK627","O2-DD-9DE6FL","Japan 225 - Cash","-","0.2","39,267.63","-","-","-","-","7,853.52","-5.32","99,355.71","-","-","-","-","-","-","-","-","-","-","-","-","-","-","-","-","-","-","-","-","-","-","-","-","-"
"10 Dec 2024 00:41:02","Close Bet","O2-DD-9DE6FX","T2-DD-5PK612","O2-DD-9DE6FL","Japan 225 - Cash","-","0.8","39,302.27","-","-","-","-","31,441.81","6.45","99,361.03","-","-","-","-","-","-","-","-","-","-","-","-","-","-","-","-","-","-","-","-","-","-","-","-","-"
"10 Dec 2024 00:41:02","Close Bet","O2-DD-9DE6FX","T2-DD-5PK611","O2-DD-9DE6DY","Japan 225 - Cash","-","0.2","39,302.27","-","-","-","-","7,860.45","3.69","99,354.58","-","-","-","-","-","-","-","-","-","-","-","-","-","-","-","-","-","-","-","-","-","-","-","-","-"
"10 Dec 2024 00:37:10","Close Bet","O2-DD-9DE6CZ","T2-DD-5PK5ZV","O2-DD-9DE6CG","Japan 225 - Cash","-","0.2","39,288.79","-","-","-","-","7,857.75","-5.40","99,350.89","-","-","-","-","-","-","-","-","-","-","-","-","-","-","-","-","-","-","-","-","-","-","-","-","-"
"10 Dec 2024 00:35:58","Close Bet","O2-DD-9DE6BQ","T2-DD-5PK5ZJ","O2-DD-9DE69V","Japan 225 - Cash","-","0.2","39,283.55","-","-","-","-","7,856.71","-4.40","99,356.29","-","-","-","-","-","-","-","-","-","-","-","-","-","-","-","-","-","-","-","-","-","-","-","-","-"
"10 Dec 2024 00:35:47","Close Bet","O2-DD-9DE6BC","T2-DD-5PK5ZD","O2-DD-9DE66N","Japan 225 - Cash","-","0.2","39,276.05","-","-","-","-","7,855.21","-3.91","99,360.69","-","-","-","-","-","-","-","-","-","-","-","-","-","-","-","-","-","-","-","-","-","-","-","-","-"
"10 Dec 2024 00:35:20","Close Bet","O2-DD-9DE69N","T2-DD-5PK5Z3","O2-DD-9DE67H","Japan 225 - Dec 2024","-","0.2","39,260.0","-","-","-","-","7,852.00","-5.00","99,364.60","-","-","-","-","-","-","-","-","-","-","-","-","-","-","-","-","-","-","-","-","-","-","-","-","-"
"10 Dec 2024 00:27:26","Close Bet","O2-DD-9DE622","T2-DD-5PK5TW","O2-DD-9DE5YZ","Japan 225 - Cash","-","0.2","39,268.39","-","-","-","-","7,853.67","2.06","99,369.60","-","-","-","-","-","-","-","-","-","-","-","-","-","-","-","-","-","-","-","-","-","-","-","-","-"
"10 Dec 2024 00:26:23","Close Bet","O2-DD-9DE619","T2-DD-5PK5TL","O2-DD-9DE5YZ","Japan 225 - Cash","-","0.1","39,268.47","-","-","-","-","3,926.84","1.02","99,367.54","-","-","-","-","-","-","-","-","-","-","-","-","-","-","-","-","-","-","-","-","-","-","-","-","-"
"10 Dec 2024 00:26:23","Close Bet","O2-DD-9DE619","T2-DD-5PK5TK","O2-DD-9DE5WT","Japan 225 - Cash","-","0.2","39,268.47","-","-","-","-","7,853.69","7.58","99,366.52","-","-","-","-","-","-","-","-","-","-","-","-","-","-","-","-","-","-","-","-","-","-","-","-","-"
"10 Dec 2024 00:22:09","Close Bet","O2-DD-9DE5YB","T2-DD-5PK5RQ","O2-DD-9DE5WT","Japan 225 - Cash","-","0.1","39,303.33","-","-","-","-","3,930.33","0.30","99,358.94","-","-","-","-","-","-","-","-","-","-","-","-","-","-","-","-","-","-","-","-","-","-","-","-","-"
"10 Dec 2024 00:22:09","Close Bet","O2-DD-9DE5YB","T2-DD-5PK5RP","O2-DD-9DE5WC","Japan 225 - Cash","-","0.2","39,303.33","-","-","-","-","7,860.66","3.56","99,358.64","-","-","-","-","-","-","-","-","-","-","-","-","-","-","-","-","-","-","-","-","-","-","-","-","-"
"10 Dec 2024 00:21:41","Close Bet","O2-DD-9DE5XS","T2-DD-5PK5RC","O2-DD-9DE5WC","Japan 225 - Cash","-","0.3","39,281.00","-","-","-","-","11,784.30","12.04","99,355.08","-","-","-","-","-","-","-","-","-","-","-","-","-","-","-","-","-","-","-","-","-","-","-","-","-"
"10 Dec 2024 00:21:11","Close Bet","O2-DD-9DE5XJ","T2-DD-5PK5R6","O2-DD-9DE5WC","Japan 225 - Cash","-","0.3","39,283.55","-","-","-","-","11,785.06","11.27","99,343.04","-","-","-","-","-","-","-","-","-","-","-","-","-","-","-","-","-","-","-","-","-","-","-","-","-"
"10 Dec 2024 00:21:01","Close Bet","O2-DD-9DE5XB","T2-DD-5PK5R1","O2-DD-9DE5W7","Japan 225 - Cash","-","0.2","39,283.52","-","-","-","-","7,856.70","6.51","99,331.77","-","-","-","-","-","-","-","-","-","-","-","-","-","-","-","-","-","-","-","-","-","-","-","-","-"
"10 Dec 2024 00:21:01","Close Bet","O2-DD-9DE5XB","T2-DD-5PK5R0","O2-DD-9DE5VX","Japan 225 - Cash","-","0.1","39,283.52","-","-","-","-","3,928.35","5.74","99,325.26","-","-","-","-","-","-","-","-","-","-","-","-","-","-","-","-","-","-","-","-","-","-","-","-","-"
"10 Dec 2024 00:20:09","Close Bet","O2-DD-9DE5WN","T2-DD-5PK5QG","O2-DD-9DE5VX","Japan 225 - Cash","-","0.1","39,325.75","-","-","-","-","3,932.57","1.52","99,319.52","-","-","-","-","-","-","-","-","-","-","-","-","-","-","-","-","-","-","-","-","-","-","-","-","-"
"10 Dec 2024 00:20:09","Close Bet","O2-DD-9DE5WN","T2-DD-5PK5QF","O2-DD-9DE5VB","Japan 225 - Cash","-","0.2","39,325.75","-","-","-","-","7,865.15","4.04","99,318.00","-","-","-","-","-","-","-","-","-","-","-","-","-","-","-","-","-","-","-","-","-","-","-","-","-"
"10 Dec 2024 00:18:55","Close Bet","O2-DD-9DE5VS","T2-DD-5PK5PY","O2-DD-9DE5TL","Japan 225 - Cash","-","0.2","39,352.94","-","-","-","-","7,870.58","-1.37","99,313.96","-","-","-","-","-","-","-","-","-","-","-","-","-","-","-","-","-","-","-","-","-","-","-","-","-"
"10 Dec 2024 00:18:06","Close Bet","O2-DD-9DE5V2","T2-DD-5PK5PE","O2-DD-9DE5T3","Japan 225 - Cash","-","0.2","39,362.98","-","-","-","-","7,872.59","-2.36","99,315.33","-","-","-","-","-","-","-","-","-","-","-","-","-","-","-","-","-","-","-","-","-","-","-","-","-"
"10 Dec 2024 00:16:02","Close Bet","O2-DD-9DE5SJ","T2-DD-5PK5NC","O2-DD-9DE5PL","Japan 225 - Cash","-","0.8","39,356.14","-","-","-","-","31,484.91","-5.26","99,317.69","-","-","-","-","-","-","-","-","-","-","-","-","-","-","-","-","-","-","-","-","-","-","-","-","-"
"10 Dec 2024 00:15:14","Close Bet","O2-DD-9DE5RY","T2-DD-5PK5MY","O2-DD-9DE5KG","Japan 225 - Cash","-","0.8","39,324.05","-","-","-","-","31,459.24","62.40","99,322.95","-","-","-","-","-","-","-","-","-","-","-","-","-","-","-","-","-","-","-","-","-","-","-","-","-"
"10 Dec 2024 00:14:00","Close Bet","O2-DD-9DE5Q1","T2-DD-5PK5LS","O2-DD-9DE5JV","Japan 225 - Cash","-","0.8","39,354.06","-","-","-","-","31,483.24","38.39","99,260.55","-","-","-","-","-","-","-","-","-","-","-","-","-","-","-","-","-","-","-","-","-","-","-","-","-"
"10 Dec 2024 00:12:57","Close Bet","O2-DD-9DE5NK","T2-DD-5PK5L9","O2-DD-9DE5HX","Japan 225 - Cash","-","0.8","39,381.55","-","-","-","-","31,505.24","20.40","99,222.16","-","-","-","-","-","-","-","-","-","-","-","-","-","-","-","-","-","-","-","-","-","-","-","-","-"
"10 Dec 2024 00:05:43","Close Bet","O2-DD-9DE5EN","T2-DD-5PK5F3","O2-DD-9DE596","Japan 225 - Cash","-","0.8","39,474.04","-","-","-","-","31,579.23","-81.60","99,201.76","-","-","-","-","-","-","-","-","-","-","-","-","-","-","-","-","-","-","-","-","-","-","-","-","-"
"10 Dec 2024 00:05:18","Close Bet","O2-DD-9DE5E9","T2-DD-5PK5EX","O2-DD-9DE58V","Japan 225 - Cash","-","0.8","39,469.04","-","-","-","-","31,575.23","-77.60","99,283.36","-","-","-","-","-","-","-","-","-","-","-","-","-","-","-","-","-","-","-","-","-","-","-","-","-"
"10 Dec 2024 00:01:37","Close Bet","O2-DD-9DE58L","T2-DD-5PK5BT","O2-DD-9DE57G","Japan 225 - Cash","-","0.2","39,367.04","-","-","-","-","7,873.40","-15.40","99,360.96","-","-","-","-","-","-","-","-","-","-","-","-","-","-","-","-","-","-","-","-","-","-","-","-","-"
"09 Dec 2024 08:21:39","Take Profit","O2-DD-9DC7Q5","T2-DD-5PJ021","-","Crude Oil West Texas - Cash","-","0.3","68.242","-","-","-","-","2,047.26","22.41","99,375.88","-","-","-","-","-","-","-","-","-","-","-","-","-","-","-","-","-","-","-","-","-","-","-","-","-"
"09 Dec 2024 01:20:43","Close Bet","O2-DD-9DC80P","T2-DD-5PHPHT","O2-DD-9DC7T8","Japan 225 - Cash","-","2","39,173.16","-","-","-","-","78,346.32","26.62","99,353.47","-","-","-","-","-","-","-","-","-","-","-","-","-","-","-","-","-","-","-","-","-","-","-","-","-"
"09 Dec 2024 01:18:01","Close Bet","O2-DD-9DC7X9","T2-DD-5PHPE2","O2-DD-9DC7RH","Japan 225 - Cash","-","0.5","39,163.10","-","-","-","-","19,581.55","10.55","99,326.85","-","-","-","-","-","-","-","-","-","-","-","-","-","-","-","-","-","-","-","-","-","-","-","-","-"
"09 Dec 2024 01:13:04","Close Bet","O2-DD-9DC7R0","T2-DD-5PHP8Y","O2-DD-9DC7NP","Japan 225 - Cash","-","0.5","39,144.45","-","-","-","-","19,572.22","-16.15","99,316.30","-","-","-","-","-","-","-","-","-","-","-","-","-","-","-","-","-","-","-","-","-","-","-","-","-"
"09 Dec 2024 01:10:49","Close Bet","O2-DD-9DC7MS","T2-DD-5PHP6B","O2-DD-9DC7J1","Japan 225 - Cash","-","0.5","39,132.02","-","-","-","-","19,566.01","-13.31","99,332.45","-","-","-","-","-","-","-","-","-","-","-","-","-","-","-","-","-","-","-","-","-","-","-","-","-"
"09 Dec 2024 01:10:28","Close Bet","O2-DD-9DC7MD","T2-DD-5PHP67","O2-DD-9DC7GQ","Japan 225 - Cash","-","0.5","39,124.51","-","-","-","-","19,562.25","-7.15","99,345.76","-","-","-","-","-","-","-","-","-","-","-","-","-","-","-","-","-","-","-","-","-","-","-","-","-"
"09 Dec 2024 01:10:20","Close Bet","O2-DD-9DC7M4","T2-DD-5PHP63","O2-DD-9DC7GK","Japan 225 - Cash","-","0.5","39,141.98","-","-","-","-","19,570.99","1.57","99,352.91","-","-","-","-","-","-","-","-","-","-","-","-","-","-","-","-","-","-","-","-","-","-","-","-","-"
"09 Dec 2024 01:06:28","Close Bet","O2-DD-9DC7H3","T2-DD-5PHP3S","O2-DD-9DC79P","Japan 225 - Cash","-","0.5","39,129.28","-","-","-","-","19,564.64","5.70","99,351.34","-","-","-","-","-","-","-","-","-","-","-","-","-","-","-","-","-","-","-","-","-","-","-","-","-"
"09 Dec 2024 01:05:42","Close Bet","O2-DD-9DC7GC","T2-DD-5PHP3F","O2-DD-9DC773","Japan 225 - Cash","-","0.5","39,116.88","-","-","-","-","19,558.44","2.32","99,345.64","-","-","-","-","-","-","-","-","-","-","-","-","-","-","-","-","-","-","-","-","-","-","-","-","-"
"09 Dec 2024 00:55:45","Close Bet","O2-DD-9DC75K","T2-DD-5PHNWR","O2-DD-9DC74N","Japan 225 - Cash","-","3","39,089.95","-","-","-","-","117,269.85","24.18","99,343.32","-","-","-","-","-","-","-","-","-","-","-","-","-","-","-","-","-","-","-","-","-","-","-","-","-"
"09 Dec 2024 00:54:23","Stop Loss","O2-DD-9DC74D","T2-DD-5PHNW1","-","USD/JPY","-","0.5","149.840","-","-","-","-","7,492.00","-3.50","99,319.14","-","-","-","-","-","-","-","-","-","-","-","-","-","-","-","-","-","-","-","-","-","-","-","-","-"
"09 Dec 2024 00:49:55","Close Bet","O2-DD-9DC71T","T2-DD-5PHNSZ","O2-DC-9D88HX","USD/CHF","-","1","0.87891","-","-","-","-","8,789.10","10.90","99,322.64","-","-","-","-","-","-","-","-","-","-","-","-","-","-","-","-","-","-","-","-","-","-","-","-","-"
"09 Dec 2024 00:48:48","Close Bet","O2-DD-9DC70N","T2-DD-5PHNSN","O2-DD-9DC6NF","Japan 225 - Cash","-","3","39,104.63","-","-","-","-","117,313.89","244.50","99,311.74","-","-","-","-","-","-","-","-","-","-","-","-","-","-","-","-","-","-","-","-","-","-","-","-","-"
"09 Dec 2024 00:38:41","Close Bet","O2-DD-9DC6KX","T2-DD-5PHNLC","O2-DD-9DC6KB","Japan 225 - Cash","-","3","39,011.37","-","-","-","-","117,034.11","-96.21","99,067.24","-","-","-","-","-","-","-","-","-","-","-","-","-","-","-","-","-","-","-","-","-","-","-","-","-"
"09 Dec 2024 00:38:01","Close Bet","O2-DD-9DC6K0","T2-DD-5PHNL4","O2-DD-9DC6JP","Japan 225 - Cash","-","3","39,021.46","-","-","-","-","117,064.38","-65.94","99,163.45","-","-","-","-","-","-","-","-","-","-","-","-","-","-","-","-","-","-","-","-","-","-","-","-","-"
"09 Dec 2024 00:36:20","Close Bet","O2-DD-9DC6FL","T2-DD-5PHNK8","O2-DD-9DC6E9","Japan 225 - Cash","-","3","39,023.90","-","-","-","-","117,071.70","83.55","99,229.39","-","-","-","-","-","-","-","-","-","-","-","-","-","-","-","-","-","-","-","-","-","-","-","-","-"
"06 Dec 2024 20:09:35","Close Bet","O2-DC-9DBXNZ","T2-DC-5PHGNM","O2-DC-9DBXN5","US NDAQ 100 - Cash","-","2","21,597.08","-","-","-","-","43,194.16","3.10","99,147.02","-","-","-","-","-","-","-","-","-","-","-","-","-","-","-","-","-","-","-","-","-","-","-","-","-"
"06 Dec 2024 15:51:26","Close Bet","O2-DC-9DBKJF","T2-DC-5PH66L","O2-DC-9D9S0F","Crude Oil West Texas - Cash","-","3","67.338","-","-","-","-","20,201.40","236.70","99,143.92","-","-","-","-","-","-","-","-","-","-","-","-","-","-","-","-","-","-","-","-","-","-","-","-","-"
"06 Dec 2024 15:50:57","Close Bet","O2-DC-9DBKGJ","T2-DC-5PH64Z","O2-DC-9DB7TT","US 30 - Cash","-","1","44,794.75","-","-","-","-","44,794.75","-57.75","98,907.22","-","-","-","-","-","-","-","-","-","-","-","-","-","-","-","-","-","-","-","-","-","-","-","-","-"
"06 Dec 2024 08:47:16","Close Bet","O2-DC-9D9RYD","T2-DC-5PGHE8","O2-DC-9D9RDW","Crude Oil West Texas - Cash","-","1","68.252","-","-","-","-","6,825.20","-22.10","98,964.97","-","-","-","-","-","-","-","-","-","-","-","-","-","-","-","-","-","-","-","-","-","-","-","-","-"
"06 Dec 2024 08:47:05","Close Bet","O2-DC-9D9RXR","T2-DC-5PGHDX","O2-DC-9D9RHP","Gasoline - Cash","-","2","1.9553","-","-","-","-","3,910.60","-15.80","98,987.07","-","-","-","-","-","-","-","-","-","-","-","-","-","-","-","-","-","-","-","-","-","-","-","-","-"
"06 Dec 2024 08:46:25","Close Bet","O2-DC-9D9RWG","T2-DC-5PGHCG","O2-DC-9D85HJ","GBP/USD","-","0.2","1.27624","-","-","-","-","2,552.48","6.84","99,002.87","-","-","-","-","-","-","-","-","-","-","-","-","-","-","-","-","-","-","-","-","-","-","-","-","-"
"06 Dec 2024 08:45:55","Close Bet","O2-DC-9D9RVN","T2-DC-5PGHBV","O2-DC-9D9RQF","USD/JPY","-","2","150.357","-","-","-","-","30,071.40","1.40","98,996.03","-","-","-","-","-","-","-","-","-","-","-","-","-","-","-","-","-","-","-","-","-","-","-","-","-"
"06 Dec 2024 08:43:55","Close Bet","O2-DC-9D9RQF","T2-DC-5PGH74","O2-DC-9D9R5W","USD/JPY","-","2","150.350","-","-","-","-","30,070.00","-5.20","98,994.63","-","-","-","-","-","-","-","-","-","-","-","-","-","-","-","-","-","-","-","-","-","-","-","-","-"
"06 Dec 2024 08:33:34","Close Bet","O2-DC-9D9R5W","T2-DC-5PGGPW","O2-DC-9D9R1X","USD/JPY","-","2","150.324","-","-","-","-","30,064.80","-11.00","98,999.83","-","-","-","-","-","-","-","-","-","-","-","-","-","-","-","-","-","-","-","-","-","-","-","-","-"
"06 Dec 2024 08:15:28","Close Bet","O2-DC-9D9QG0","T2-DC-5PGG4R","O2-DC-9D9E2Q","Crude Oil West Texas - Cash","-","1","68.357","-","-","-","-","6,835.70","12.60","99,010.83","-","-","-","-","-","-","-","-","-","-","-","-","-","-","-","-","-","-","-","-","-","-","-","-","-"
"06 Dec 2024 08:06:14","Close Bet","O2-DC-9D9Q1C","T2-DC-5PGFSG","O2-DC-9D9H88","GBP/JPY","-","3","191.791","-","-","-","-","57,537.30","-207.60","98,998.23","-","-","-","-","-","-","-","-","-","-","-","-","-","-","-","-","-","-","-","-","-","-","-","-","-"
"06 Dec 2024 02:15:39","Close Bet","O2-DC-9D9HFZ","T2-DC-5PG9EK","O2-DC-9D9H6X","USD/JPY","-","5","149.949","-","-","-","-","74,974.50","2.50","99,205.83","-","-","-","-","-","-","-","-","-","-","-","-","-","-","-","-","-","-","-","-","-","-","-","-","-"
"06 Dec 2024 01:37:52","Close Bet","O2-DC-9D9GB0","T2-DC-5PG8J4","O2-DC-9D9G9J","Japan 225 - Cash","-","2","39,124.53","-","-","-","-","78,249.06","-33.70","99,203.33","-","-","-","-","-","-","-","-","-","-","-","-","-","-","-","-","-","-","-","-","-","-","-","-","-"
"06 Dec 2024 00:50:58","Close Bet","O2-DC-9D9F5V","T2-DC-5PG7G5","O2-DC-9D9EJD","Japan 225 - Cash","-","3","39,111.56","-","-","-","-","117,334.68","475.80","99,237.03","-","-","-","-","-","-","-","-","-","-","-","-","-","-","-","-","-","-","-","-","-","-","-","-","-"
"06 Dec 2024 00:04:27","Close Bet","O2-DC-9D9EHQ","T2-DC-5PG6YD","O2-DC-9D9EFM","Japan 225 - Cash","-","3","39,335.15","-","-","-","-","118,005.45","-245.94","98,761.23","-","-","-","-","-","-","-","-","-","-","-","-","-","-","-","-","-","-","-","-","-","-","-","-","-"
"05 Dec 2024 23:57:50","Stop Loss","O2-DC-9D9EB0","T2-DC-5PG6VQ","-","Japan 225 - Cash","-","3","39,379.29","-","-","-","-","118,137.87","-68.49","99,007.17","-","-","-","-","-","-","-","-","-","-","-","-","-","-","-","-","-","-","-","-","-","-","-","-","-"
"05 Dec 2024 23:48:41","Stop Loss","O2-DC-9D9E9V","T2-DC-5PG6S7","-","Japan 225 - Cash","-","10","39,397.12","-","-","-","-","393,971.20","-100.00","99,075.66","-","-","-","-","-","-","-","-","-","-","-","-","-","-","-","-","-","-","-","-","-","-","-","-","-"
"05 Dec 2024 23:48:23","Stop Loss","O2-DC-9D9E9G","T2-DC-5PG6S0","-","Japan 225 - Cash","-","7","39,407.12","-","-","-","-","275,849.84","-70.00","99,175.66","-","-","-","-","-","-","-","-","-","-","-","-","-","-","-","-","-","-","-","-","-","-","-","-","-"
"05 Dec 2024 23:48:23","Close Bet","O2-DC-9D9E9G","T2-DC-5PG6RY","O2-DC-9D9DL6","Japan 225 - Cash","-","3","39,417.12","-","-","-","-","118,251.36","-516.00","99,245.66","-","-","-","-","-","-","-","-","-","-","-","-","-","-","-","-","-","-","-","-","-","-","-","-","-"
"05 Dec 2024 20:01:17","Close Bet","O2-DC-9D97Y9","T2-DC-5PG28J","O2-DC-9D91EV","US 30 - Cash","-","1","44,821.27","-","-","-","-","44,821.27","-53.06","99,762.90","-","-","-","-","-","-","-","-","-","-","-","-","-","-","-","-","-","-","-","-","-","-","-","-","-"
"05 Dec 2024 20:01:17","Close Bet","O2-DC-9D97Y9","T2-DC-5PG28H","O2-DC-9D8T7Z","US 30 - Cash","-","1","44,821.27","-","-","-","-","44,821.27","-100.96","99,815.96","-","-","-","-","-","-","-","-","-","-","-","-","-","-","-","-","-","-","-","-","-","-","-","-","-"
"05 Dec 2024 20:01:17","Close Bet","O2-DC-9D97Y9","T2-DC-5PG28G","O2-DC-9D8R94","US 30 - Cash","-","1","44,821.27","-","-","-","-","44,821.27","-156.51","99,916.92","-","-","-","-","-","-","-","-","-","-","-","-","-","-","-","-","-","-","-","-","-","-","-","-","-"
"05 Dec 2024 20:00:42","Close Bet","O2-DC-9D97XM","T2-DC-5PG282","O2-DC-9D8FFR","Crude Oil West Texas - Cash","-","1","68.719","-","-","-","-","6,871.90","4.30","100,073.43","-","-","-","-","-","-","-","-","-","-","-","-","-","-","-","-","-","-","-","-","-","-","-","-","-"
"05 Dec 2024 20:00:42","Close Bet","O2-DC-9D97XM","T2-DC-5PG281","O2-DC-9D8D6D","Crude Oil West Texas - Cash","-","2","68.719","-","-","-","-","13,743.80","-113.60","100,069.13","-","-","-","-","-","-","-","-","-","-","-","-","-","-","-","-","-","-","-","-","-","-","-","-","-"
"05 Dec 2024 18:29:57","Close Bet","O2-DC-9D9465","T2-DC-5PFYYH","O2-DC-9D93VE","US 30 - Cash","-","1","44,852.50","-","-","-","-","44,852.50","35.06","100,182.73","-","-","-","-","-","-","-","-","-","-","-","-","-","-","-","-","-","-","-","-","-","-","-","-","-"
"05 Dec 2024 15:48:14","Close Bet","O2-DC-9D8VMH","T2-DC-5PFQ7S","O2-DC-9D8FJS","USD/CAD","-","0.5","1.40436","-","-","-","-","7,021.80","1.30","100,147.67","-","-","-","-","-","-","-","-","-","-","-","-","-","-","-","-","-","-","-","-","-","-","-","-","-"
"05 Dec 2024 15:32:12","Close Bet","O2-DC-9D8TBF","T2-DC-5PFP4W","O2-DC-9D8QSK","US 30 - Cash","-","1","44,920.04","-","-","-","-","44,920.04","-134.18","100,146.37","-","-","-","-","-","-","-","-","-","-","-","-","-","-","-","-","-","-","-","-","-","-","-","-","-"
"05 Dec 2024 14:12:40","Close Bet","O2-DC-9D8JZC","T2-DC-5PFFZ5","O2-DC-9D8FL9","Japan 225 - Cash","-","0.5","39,587.22","-","-","-","-","19,793.61","22.77","100,280.55","-","-","-","-","-","-","-","-","-","-","-","-","-","-","-","-","-","-","-","-","-","-","-","-","-"
"05 Dec 2024 12:02:21","Close Bet","O2-DC-9D8D6D","T2-DC-5PFB7F","O2-DC-9D8BGQ","Crude Oil West Texas - Cash","-","1","68.151","-","-","-","-","6,815.10","-89.70","100,257.78","-","-","-","-","-","-","-","-","-","-","-","-","-","-","-","-","-","-","-","-","-","-","-","-","-"
"05 Dec 2024 12:02:11","Close Bet","O2-DC-9D8D65","T2-DC-5PFB79","O2-DC-9D8BG7","Gasoline - Cash","-","1","1.9472","-","-","-","-","1,947.20","-23.20","100,347.48","-","-","-","-","-","-","-","-","-","-","-","-","-","-","-","-","-","-","-","-","-","-","-","-","-"
"05 Dec 2024 09:03:08","Close Bet","O2-DC-9D85Y8","T2-DC-5PF519","O2-DC-9D84DV","Gasoline - Cash","-","1","1.9625","-","-","-","-","1,962.50","-5.20","100,370.68","-","-","-","-","-","-","-","-","-","-","-","-","-","-","-","-","-","-","-","-","-","-","-","-","-"
"05 Dec 2024 00:08:52","Close Bet","O2-DC-9D7RZM","T2-DC-5PETDT","O2-DC-9D7RYL","GBP/JPY","-","2","190.949","-","-","-","-","38,189.80","7.00","100,375.88","-","-","-","-","-","-","-","-","-","-","-","-","-","-","-","-","-","-","-","-","-","-","-","-","-"
"05 Dec 2024 00:07:12","Close Bet","O2-DC-9D7RY2","T2-DC-5PETCX","O2-DC-9D7RWM","Japan 225 - Cash","-","2","39,592.01","-","-","-","-","79,184.02","11.00","100,368.88","-","-","-","-","-","-","-","-","-","-","-","-","-","-","-","-","-","-","-","-","-","-","-","-","-"
"04 Dec 2024 20:56:25","Close Bet","O2-DC-9D7NYM","T2-DC-5PER6K","O2-DC-9D7NX3","GBP/JPY","-","0.2","191.244","-","-","-","-","3,824.88","0.96","100,357.88","-","-","-","-","-","-","-","-","-","-","-","-","-","-","-","-","-","-","-","-","-","-","-","-","-"
"04 Dec 2024 20:56:25","Close Bet","O2-DC-9D7NYM","T2-DC-5PER6J","O2-DC-9D7NTR","GBP/JPY","-","0.2","191.244","-","-","-","-","3,824.88","1.28","100,356.92","-","-","-","-","-","-","-","-","-","-","-","-","-","-","-","-","-","-","-","-","-","-","-","-","-"
"04 Dec 2024 20:56:25","Close Bet","O2-DC-9D7NYM","T2-DC-5PER6H","O2-DC-9D7NTL","GBP/JPY","-","0.2","191.244","-","-","-","-","3,824.88","1.42","100,355.64","-","-","-","-","-","-","-","-","-","-","-","-","-","-","-","-","-","-","-","-","-","-","-","-","-"
"04 Dec 2024 20:56:25","Close Bet","O2-DC-9D7NYM","T2-DC-5PER6G","O2-DC-9D7NT0","GBP/JPY","-","0.2","191.244","-","-","-","-","3,824.88","1.46","100,354.22","-","-","-","-","-","-","-","-","-","-","-","-","-","-","-","-","-","-","-","-","-","-","-","-","-"
"04 Dec 2024 20:54:47","Close Bet","O2-DC-9D7NWH","T2-DC-5PER4W","O2-DC-9D7NPP","US 30 - Cash","-","0.3","45,048.46","-","-","-","-","13,514.53","-5.00","100,352.76","-","-","-","-","-","-","-","-","-","-","-","-","-","-","-","-","-","-","-","-","-","-","-","-","-"
"04 Dec 2024 20:54:27","Close Bet","O2-DC-9D7NW6","T2-DC-5PER4L","O2-DC-9D7NRC","Gold - Cash","-","2","2,650.12","-","-","-","-","5,300.24","0.82","100,357.76","-","-","-","-","-","-","-","-","-","-","-","-","-","-","-","-","-","-","-","-","-","-","-","-","-"
"04 Dec 2024 20:46:42","Close Bet","O2-DC-9D7NK0","T2-DC-5PEQV9","O2-DC-9D7NFH","US 30 - Cash","-","0.3","45,048.36","-","-","-","-","13,514.50","0.50","100,356.94","-","-","-","-","-","-","-","-","-","-","-","-","-","-","-","-","-","-","-","-","-","-","-","-","-"
"04 Dec 2024 20:13:03","Close Bet","O2-DC-9D7ME1","T2-DC-5PEPV6","O2-DC-9D7M4T","US 30 - Cash","-","0.3","45,029.39","-","-","-","-","13,508.81","9.45","100,356.44","-","-","-","-","-","-","-","-","-","-","-","-","-","-","-","-","-","-","-","-","-","-","-","-","-"
"04 Dec 2024 20:13:03","Close Bet","O2-DC-9D7ME1","T2-DC-5PEPV5","O2-DC-9D7M2F","US 30 - Cash","-","0.3","45,029.39","-","-","-","-","13,508.81","13.57","100,346.99","-","-","-","-","-","-","-","-","-","-","-","-","-","-","-","-","-","-","-","-","-","-","-","-","-"
"04 Dec 2024 20:13:00","Close Bet","O2-DC-9D7MDY","T2-DC-5PEPV3","O2-DC-9D7JW0","Gold - Cash","-","2","2,649.93","-","-","-","-","5,299.86","-10.48","100,333.42","-","-","-","-","-","-","-","-","-","-","-","-","-","-","-","-","-","-","-","-","-","-","-","-","-"
"04 Dec 2024 20:07:51","Close Bet","O2-DC-9D7M61","T2-DC-5PEPMB","O2-DC-9D7KXE","USD/JPY","-","0.5","150.555","-","-","-","-","7,527.75","-15.80","100,343.90","-","-","-","-","-","-","-","-","-","-","-","-","-","-","-","-","-","-","-","-","-","-","-","-","-"
"04 Dec 2024 19:43:01","Close Bet","O2-DC-9D7L9S","T2-DC-5PENYH","O2-DC-9D7KQ9","Crude Oil West Texas - Cash","-","0.5","68.854","-","-","-","-","3,442.70","6.30","100,359.70","-","-","-","-","-","-","-","-","-","-","-","-","-","-","-","-","-","-","-","-","-","-","-","-","-"
"04 Dec 2024 19:40:51","Close Bet","O2-DC-9D7L7D","T2-DC-5PENVX","O2-DC-9D7KZN","US 30 - Cash","-","0.3","44,977.07","-","-","-","-","13,493.12","1.97","100,353.40","-","-","-","-","-","-","-","-","-","-","-","-","-","-","-","-","-","-","-","-","-","-","-","-","-"
"04 Dec 2024 19:40:51","Close Bet","O2-DC-9D7L7D","T2-DC-5PENVW","O2-DC-9D7KX3","US 30 - Cash","-","0.3","44,977.07","-","-","-","-","13,493.12","5.14","100,351.43","-","-","-","-","-","-","-","-","-","-","-","-","-","-","-","-","-","-","-","-","-","-","-","-","-"
"04 Dec 2024 19:23:39","Close Bet","O2-DC-9D7KEK","T2-DC-5PEN6T","O2-DC-9D7K6T","US 30 - Cash","-","0.3","44,948.61","-","-","-","-","13,484.58","0.80","100,346.29","-","-","-","-","-","-","-","-","-","-","-","-","-","-","-","-","-","-","-","-","-","-","-","-","-"
"04 Dec 2024 19:23:16","Close Bet","O2-DC-9D7KDK","T2-DC-5PEN5P","O2-DC-9D7K3G","Crude Oil West Texas - Cash","-","0.5","68.854","-","-","-","-","3,442.70","-9.25","100,345.49","-","-","-","-","-","-","-","-","-","-","-","-","-","-","-","-","-","-","-","-","-","-","-","-","-"
"04 Dec 2024 19:19:57","Close Bet","O2-DC-9D7K5M","T2-DC-5PEMYJ","O2-DC-9D7K02","US 30 - Cash","-","0.3","44,937.52","-","-","-","-","13,481.25","4.58","100,354.74","-","-","-","-","-","-","-","-","-","-","-","-","-","-","-","-","-","-","-","-","-","-","-","-","-"
"04 Dec 2024 19:19:57","Close Bet","O2-DC-9D7K5M","T2-DC-5PEMYH","O2-DC-9D7JXF","US 30 - Cash","-","0.3","44,937.52","-","-","-","-","13,481.25","5.35","100,350.16","-","-","-","-","-","-","-","-","-","-","-","-","-","-","-","-","-","-","-","-","-","-","-","-","-"
"04 Dec 2024 19:15:45","Close Bet","O2-DC-9D7JVD","T2-DC-5PEMN5","O2-DC-9D7HSB","US NDAQ 100 - Cash","-","0.5","21,438.36","-","-","-","-","10,719.18","2.13","100,344.81","-","-","-","-","-","-","-","-","-","-","-","-","-","-","-","-","-","-","-","-","-","-","-","-","-"
"04 Dec 2024 19:14:21","Close Bet","O2-DC-9D7JSR","T2-DC-5PEMLY","O2-DC-9D7JNZ","Gold - Cash","-","2","2,652.49","-","-","-","-","5,304.98","0.00","100,342.68","-","-","-","-","-","-","-","-","-","-","-","-","-","-","-","-","-","-","-","-","-","-","-","-","-"
"04 Dec 2024 19:14:21","Close Bet","O2-DC-9D7JSR","T2-DC-5PEMLX","O2-DC-9D7JNQ","Gold - Cash","-","2","2,652.49","-","-","-","-","5,304.98","0.34","100,342.68","-","-","-","-","-","-","-","-","-","-","-","-","-","-","-","-","-","-","-","-","-","-","-","-","-"
"04 Dec 2024 19:14:21","Close Bet","O2-DC-9D7JSR","T2-DC-5PEMLW","O2-DC-9D7JNG","Gold - Cash","-","2","2,652.49","-","-","-","-","5,304.98","0.88","100,342.34","-","-","-","-","-","-","-","-","-","-","-","-","-","-","-","-","-","-","-","-","-","-","-","-","-"
"04 Dec 2024 19:05:50","Close Bet","O2-DC-9D7JGS","T2-DC-5PEMCT","O2-DC-9D7HQG","USD/JPY","-","0.5","150.377","-","-","-","-","7,518.85","3.65","100,341.46","-","-","-","-","-","-","-","-","-","-","-","-","-","-","-","-","-","-","-","-","-","-","-","-","-"
"04 Dec 2024 19:05:09","Close Bet","O2-DC-9D7JEQ","T2-DC-5PEMB7","O2-DC-9D7DRT","Gold - Cash","-","2","2,649.67","-","-","-","-","5,299.34","-6.68","100,337.81","-","-","-","-","-","-","-","-","-","-","-","-","-","-","-","-","-","-","-","-","-","-","-","-","-"
"04 Dec 2024 18:26:31","Close Bet","O2-DC-9D7GBV","T2-DC-5PEKF8","O2-DC-9D7G88","US NDAQ 100 - Cash","-","0.5","21,424.13","-","-","-","-","10,712.06","1.28","100,344.49","-","-","-","-","-","-","-","-","-","-","-","-","-","-","-","-","-","-","-","-","-","-","-","-","-"
"04 Dec 2024 18:22:18","Close Bet","O2-DC-9D7G68","T2-DC-5PEKBE","O2-DC-9D7FZ5","Crude Oil West Texas - Cash","-","0.1","68.924","-","-","-","-","689.24","0.45","100,343.21","-","-","-","-","-","-","-","-","-","-","-","-","-","-","-","-","-","-","-","-","-","-","-","-","-"
"04 Dec 2024 18:15:06","Close Bet","O2-DC-9D7FY3","T2-DC-5PEK3W","O2-DC-9D7FXC","US NDAQ 100 - Cash","-","0.5","21,431.71","-","-","-","-","10,715.85","-0.28","100,342.76","-","-","-","-","-","-","-","-","-","-","-","-","-","-","-","-","-","-","-","-","-","-","-","-","-"
"04 Dec 2024 18:13:45","Close Bet","O2-DC-9D7FX2","T2-DC-5PEK2D","O2-DC-9D7FW3","US NDAQ 100 - Cash","-","0.5","21,433.90","-","-","-","-","10,716.95","-0.19","100,343.04","-","-","-","-","-","-","-","-","-","-","-","-","-","-","-","-","-","-","-","-","-","-","-","-","-"
"04 Dec 2024 18:07:56","Close Bet","O2-DC-9D7FPQ","T2-DC-5PEJX8","O2-DC-9D7EN8","USD/JPY","-","0.5","150.121","-","-","-","-","7,506.05","-4.30","100,343.23","-","-","-","-","-","-","-","-","-","-","-","-","-","-","-","-","-","-","-","-","-","-","-","-","-"
"04 Dec 2024 17:21:33","Close Bet","O2-DC-9D7DQW","T2-DC-5PEH3R","O2-DC-9D7CZH","Crude Oil West Texas - Cash","-","0.1","69.465","-","-","-","-","694.65","0.80","100,347.53","-","-","-","-","-","-","-","-","-","-","-","-","-","-","-","-","-","-","-","-","-","-","-","-","-"
"04 Dec 2024 17:21:33","Close Bet","O2-DC-9D7DQW","T2-DC-5PEH3Q","O2-DC-9D7CZE","Crude Oil West Texas - Cash","-","0.1","69.465","-","-","-","-","694.65","0.80","100,346.73","-","-","-","-","-","-","-","-","-","-","-","-","-","-","-","-","-","-","-","-","-","-","-","-","-"
"04 Dec 2024 17:01:01","Close Bet","O2-DC-9D7D01","T2-DC-5PEGH0","O2-DC-9D7CLV","US 30 - Cash","-","0.3","44,934.58","-","-","-","-","13,480.37","-9.13","100,345.93","-","-","-","-","-","-","-","-","-","-","-","-","-","-","-","-","-","-","-","-","-","-","-","-","-"
"04 Dec 2024 16:40:23","Close Bet","O2-DC-9D7C35","T2-DC-5PEFRS","O2-DC-9D7BV9","Crude Oil West Texas - Cash","-","0.1","69.715","-","-","-","-","697.15","-0.30","100,355.06","-","-","-","-","-","-","-","-","-","-","-","-","-","-","-","-","-","-","-","-","-","-","-","-","-"
"04 Dec 2024 16:37:35","Close Bet","O2-DC-9D7BZV","T2-DC-5PEFP5","O2-DC-9D7B8N","Gold - Cash","-","2","2,651.23","-","-","-","-","5,302.46","-5.46","100,355.36","-","-","-","-","-","-","-","-","-","-","-","-","-","-","-","-","-","-","-","-","-","-","-","-","-"
"04 Dec 2024 16:33:55","Close Bet","O2-DC-9D7BQD","T2-DC-5PEFHD","O2-DC-9D7B9T","US 30 - Cash","-","0.3","44,930.41","-","-","-","-","13,479.12","-9.91","100,360.82","-","-","-","-","-","-","-","-","-","-","-","-","-","-","-","-","-","-","-","-","-","-","-","-","-"
"04 Dec 2024 16:21:12","Close Bet","O2-DC-9D79XC","T2-DC-5PEEVE","O2-DC-9D79M1","Crude Oil West Texas - Cash","-","0.3","69.730","-","-","-","-","2,091.90","-1.65","100,370.73","-","-","-","-","-","-","-","-","-","-","-","-","-","-","-","-","-","-","-","-","-","-","-","-","-"
"04 Dec 2024 16:20:59","Close Bet","O2-DC-9D79WR","T2-DC-5PEETY","O2-DC-9D79KY","US 30 - Cash","-","0.3","44,954.85","-","-","-","-","13,486.45","8.17","100,372.38","-","-","-","-","-","-","-","-","-","-","-","-","-","-","-","-","-","-","-","-","-","-","-","-","-"
"04 Dec 2024 16:16:57","Close Bet","O2-DC-9D79LE","T2-DC-5PEELN","O2-DC-9D78M3","Gold - Cash","-","2","2,653.97","-","-","-","-","5,307.94","-2.92","100,364.21","-","-","-","-","-","-","-","-","-","-","-","-","-","-","-","-","-","-","-","-","-","-","-","-","-"
"04 Dec 2024 16:16:57","Close Bet","O2-DC-9D79LE","T2-DC-5PEELM","O2-DC-9D78LK","Gold - Cash","-","2","2,653.97","-","-","-","-","5,307.94","-1.34","100,367.13","-","-","-","-","-","-","-","-","-","-","-","-","-","-","-","-","-","-","-","-","-","-","-","-","-"
"04 Dec 2024 16:16:21","Close Bet","O2-DC-9D79K2","T2-DC-5PEEKE","O2-DC-9D79B1","US 30 - Cash","-","1","44,920.96","-","-","-","-","44,920.96","9.53","100,368.47","-","-","-","-","-","-","-","-","-","-","-","-","-","-","-","-","-","-","-","-","-","-","-","-","-"
"04 Dec 2024 16:16:17","Close Bet","O2-DC-9D79JZ","T2-DC-5PEEK9","O2-DC-9D793S","US NDAQ 100 - Cash","-","0.5","21,422.38","-","-","-","-","10,711.19","-9.34","100,358.94","-","-","-","-","-","-","-","-","-","-","-","-","-","-","-","-","-","-","-","-","-","-","-","-","-"
"04 Dec 2024 16:16:07","Close Bet","O2-DC-9D79JE","T2-DC-5PEEJW","O2-DC-9D7924","Crude Oil West Texas - Cash","-","1","69.785","-","-","-","-","6,978.50","12.10","100,368.28","-","-","-","-","-","-","-","-","-","-","-","-","-","-","-","-","-","-","-","-","-","-","-","-","-"
"04 Dec 2024 16:02:56","Close Bet","O2-DC-9D78T4","T2-DC-5PEDZ8","O2-DC-9D78FD","US NDAQ 100 - Cash","-","0.5","21,430.39","-","-","-","-","10,715.19","-0.08","100,356.18","-","-","-","-","-","-","-","-","-","-","-","-","-","-","-","-","-","-","-","-","-","-","-","-","-"
"04 Dec 2024 15:58:57","Close Bet","O2-DC-9D78JP","T2-DC-5PEDR6","O2-DC-9D77F8","GBP/JPY","-","0.2","191.139","-","-","-","-","3,822.78","-3.00","100,356.26","-","-","-","-","-","-","-","-","-","-","-","-","-","-","-","-","-","-","-","-","-","-","-","-","-"
"04 Dec 2024 15:58:48","Close Bet","O2-DC-9D78JL","T2-DC-5PEDR2","O2-DC-9D75N8","Gasoline - Cash","-","0.5","1.9977","-","-","-","-","998.85","-5.40","100,359.26","-","-","-","-","-","-","-","-","-","-","-","-","-","-","-","-","-","-","-","-","-","-","-","-","-"
"04 Dec 2024 15:57:02","Close Bet","O2-DC-9D78DT","T2-DC-5PEDM6","O2-DC-9D7869","US 30 - Cash","-","0.2","44,862.93","-","-","-","-","8,972.58","-6.22","100,364.66","-","-","-","-","-","-","-","-","-","-","-","-","-","-","-","-","-","-","-","-","-","-","-","-","-"
"04 Dec 2024 15:57:02","Close Bet","O2-DC-9D78DT","T2-DC-5PEDM5","O2-DC-9D785R","US 30 - Cash","-","0.2","44,862.93","-","-","-","-","8,972.58","-5.42","100,370.88","-","-","-","-","-","-","-","-","-","-","-","-","-","-","-","-","-","-","-","-","-","-","-","-","-"
"04 Dec 2024 15:48:12","Stop Loss","O2-DC-9D75TN","T2-DC-5PECZB","-","Crude Oil West Texas - Cash","-","0.3","69.762","-","-","-","-","2,092.86","-9.57","100,376.30","-","-","-","-","-","-","-","-","-","-","-","-","-","-","-","-","-","-","-","-","-","-","-","-","-"
"04 Dec 2024 15:45:49","Close Bet","O2-DC-9D777Z","T2-DC-5PECP7","O2-DC-9D75JR","Crude Oil West Texas - Cash","-","0.3","69.876","-","-","-","-","2,096.28","-7.20","100,385.87","-","-","-","-","-","-","-","-","-","-","-","-","-","-","-","-","-","-","-","-","-","-","-","-","-"
"04 Dec 2024 15:44:46","Close Bet","O2-DC-9D775L","T2-DC-5PECMT","O2-DC-9D76WW","Gold - Cash","-","2","2,655.30","-","-","-","-","5,310.60","-1.90","100,393.07","-","-","-","-","-","-","-","-","-","-","-","-","-","-","-","-","-","-","-","-","-","-","-","-","-"
"04 Dec 2024 15:44:46","Close Bet","O2-DC-9D775L","T2-DC-5PECMS","O2-DC-9D76T6","Gold - Cash","-","2","2,655.30","-","-","-","-","5,310.60","-0.34","100,394.97","-","-","-","-","-","-","-","-","-","-","-","-","-","-","-","-","-","-","-","-","-","-","-","-","-"
"04 Dec 2024 15:39:18","Close Bet","O2-DC-9D76PL","T2-DC-5PEC97","O2-DC-9D769H","US 30 - Cash","-","0.2","44,870.99","-","-","-","-","8,974.19","-0.27","100,395.31","-","-","-","-","-","-","-","-","-","-","-","-","-","-","-","-","-","-","-","-","-","-","-","-","-"
"04 Dec 2024 15:38:28","Close Bet","O2-DC-9D76L6","T2-DC-5PEC6Q","O2-DC-9D759K","Gold - Cash","-","0.5","2,654.42","-","-","-","-","1,327.21","-0.69","100,395.58","-","-","-","-","-","-","-","-","-","-","-","-","-","-","-","-","-","-","-","-","-","-","-","-","-"
"04 Dec 2024 15:38:28","Close Bet","O2-DC-9D76L6","T2-DC-5PEC6P","O2-DC-9D7346","Gold - Cash","-","1.5","2,654.42","-","-","-","-","3,981.63","3.26","100,396.27","-","-","-","-","-","-","-","-","-","-","-","-","-","-","-","-","-","-","-","-","-","-","-","-","-"
"04 Dec 2024 15:38:18","Close Bet","O2-DC-9D76K4","T2-DC-5PEC62","O2-DC-9D7346","Gold - Cash","-","0.5","2,654.56","-","-","-","-","1,327.28","1.16","100,393.01","-","-","-","-","-","-","-","-","-","-","-","-","-","-","-","-","-","-","-","-","-","-","-","-","-"
"04 Dec 2024 15:38:05","Close Bet","O2-DC-9D76J7","T2-DC-5PEC5B","O2-DC-9D7346","Gold - Cash","-","0.5","2,655.03","-","-","-","-","1,327.51","1.39","100,391.85","-","-","-","-","-","-","-","-","-","-","-","-","-","-","-","-","-","-","-","-","-","-","-","-","-"
"04 Dec 2024 15:37:54","Close Bet","O2-DC-9D76H7","T2-DC-5PEC4Q","O2-DC-9D7346","Gold - Cash","-","0.5","2,655.57","-","-","-","-","1,327.78","1.66","100,390.46","-","-","-","-","-","-","-","-","-","-","-","-","-","-","-","-","-","-","-","-","-","-","-","-","-"
"04 Dec 2024 15:36:16","Close Bet","O2-DC-9D768R","T2-DC-5PEBZD","O2-DC-9D763B","US 30 - Cash","-","0.2","44,867.30","-","-","-","-","8,973.46","1.44","100,388.80","-","-","-","-","-","-","-","-","-","-","-","-","-","-","-","-","-","-","-","-","-","-","-","-","-"
"04 Dec 2024 15:35:33","Close Bet","O2-DC-9D7624","T2-DC-5PEBT9","O2-DC-9D75HS","US 30 - Cash","-","0.2","44,858.44","-","-","-","-","8,971.68","-4.61","100,387.36","-","-","-","-","-","-","-","-","-","-","-","-","-","-","-","-","-","-","-","-","-","-","-","-","-"
"04 Dec 2024 15:30:38","Close Bet","O2-DC-9D758C","T2-DC-5PEB1N","O2-DC-9D750W","US 30 - Cash","-","0.1","44,856.45","-","-","-","-","4,485.64","-1.25","100,391.97","-","-","-","-","-","-","-","-","-","-","-","-","-","-","-","-","-","-","-","-","-","-","-","-","-"
"04 Dec 2024 15:30:38","Close Bet","O2-DC-9D758C","T2-DC-5PEB1M","O2-DC-9D750J","US 30 - Cash","-","0.1","44,856.45","-","-","-","-","4,485.64","-0.62","100,393.22","-","-","-","-","-","-","-","-","-","-","-","-","-","-","-","-","-","-","-","-","-","-","-","-","-"
"04 Dec 2024 15:28:14","Close Bet","O2-DC-9D7506","T2-DC-5PE9VV","O2-DC-9D74L3","US 30 - Cash","-","0.1","44,856.72","-","-","-","-","4,485.67","-2.24","100,393.84","-","-","-","-","-","-","-","-","-","-","-","-","-","-","-","-","-","-","-","-","-","-","-","-","-"
"04 Dec 2024 15:24:27","Close Bet","O2-DC-9D74EV","T2-DC-5PE9BS","O2-DC-9D74CX","US 30 - Cash","-","0.1","44,863.54","-","-","-","-","4,486.35","-0.87","100,396.08","-","-","-","-","-","-","-","-","-","-","-","-","-","-","-","-","-","-","-","-","-","-","-","-","-"
"04 Dec 2024 15:24:16","Close Bet","O2-DC-9D74E9","T2-DC-5PE9BJ","O2-DC-9D74CD","US 30 - Cash","-","0.1","44,861.61","-","-","-","-","4,486.16","-0.69","100,396.95","-","-","-","-","-","-","-","-","-","-","-","-","-","-","-","-","-","-","-","-","-","-","-","-","-"
"04 Dec 2024 15:12:55","Close Bet","O2-DC-9D737R","T2-DC-5PE8CM","O2-DC-9D7346","Gold - Cash","-","2","2,651.22","-","-","-","-","5,302.44","-2.06","100,397.64","-","-","-","-","-","-","-","-","-","-","-","-","-","-","-","-","-","-","-","-","-","-","-","-","-"
"04 Dec 2024 15:10:56","Close Bet","O2-DC-9D730C","T2-DC-5PE86D","O2-DC-9D72N6","US 30 - Cash","-","0.1","44,896.10","-","-","-","-","4,489.61","2.44","100,399.70","-","-","-","-","-","-","-","-","-","-","-","-","-","-","-","-","-","-","-","-","-","-","-","-","-"
"04 Dec 2024 15:07:21","Stop Loss","O2-DC-9D72F6","T2-DC-5PE7RY","-","US 30 - Cash","-","0.1","44,866.30","-","-","-","-","4,486.63","-2.14","100,397.26","-","-","-","-","-","-","-","-","-","-","-","-","-","-","-","-","-","-","-","-","-","-","-","-","-"
"04 Dec 2024 15:06:05","Close Bet","O2-DC-9D72CW","T2-DC-5PE7MR","O2-DC-9D72C1","US 30 - Cash","-","0.1","44,882.06","-","-","-","-","4,488.20","-1.16","100,399.40","-","-","-","-","-","-","-","-","-","-","-","-","-","-","-","-","-","-","-","-","-","-","-","-","-"
"04 Dec 2024 14:45:30","Close Bet","O2-DC-9D706J","T2-DC-5PE5VL","O2-DC-9D700G","US 30 - Cash","-","0.1","44,984.41","-","-","-","-","4,498.44","-1.68","100,400.56","-","-","-","-","-","-","-","-","-","-","-","-","-","-","-","-","-","-","-","-","-","-","-","-","-"
"04 Dec 2024 14:45:15","Close Bet","O2-DC-9D705Y","T2-DC-5PE5V8","O2-DC-9D700G","US 30 - Cash","-","0.1","44,984.93","-","-","-","-","4,498.49","-1.63","100,402.24","-","-","-","-","-","-","-","-","-","-","-","-","-","-","-","-","-","-","-","-","-","-","-","-","-"
"04 Dec 2024 14:45:06","Close Bet","O2-DC-9D705L","T2-DC-5PE5V0","O2-DC-9D700G","US 30 - Cash","-","0.1","44,980.35","-","-","-","-","4,498.03","-2.09","100,403.87","-","-","-","-","-","-","-","-","-","-","-","-","-","-","-","-","-","-","-","-","-","-","-","-","-"
"04 Dec 2024 14:34:55","Close Bet","O2-DC-9D6YWJ","T2-DC-5PE4SX","O2-DC-9D6Y8P","US 30 - Cash","-","0.1","45,000.32","-","-","-","-","4,500.03","7.36","100,405.96","-","-","-","-","-","-","-","-","-","-","-","-","-","-","-","-","-","-","-","-","-","-","-","-","-"
"04 Dec 2024 14:33:47","Close Bet","O2-DC-9D6YPQ","T2-DC-5PE4MM","O2-DC-9D6XJG","Gold - Cash","-","5","2,652.72","-","-","-","-","13,263.60","14.80","100,398.60","-","-","-","-","-","-","-","-","-","-","-","-","-","-","-","-","-","-","-","-","-","-","-","-","-"
"04 Dec 2024 14:32:19","Close Bet","O2-DC-9D6YF2","T2-DC-5PE4D7","O2-DC-9D6Y6Z","US 30 - Cash","-","0.1","44,973.38","-","-","-","-","4,497.33","6.01","100,383.80","-","-","-","-","-","-","-","-","-","-","-","-","-","-","-","-","-","-","-","-","-","-","-","-","-"
"04 Dec 2024 14:32:07","Close Bet","O2-DC-9D6YD8","T2-DC-5PE4BY","O2-DC-9D6Y57","US 30 - Cash","-","0.1","44,952.94","-","-","-","-","4,495.29","3.22","100,377.79","-","-","-","-","-","-","-","-","-","-","-","-","-","-","-","-","-","-","-","-","-","-","-","-","-"
"04 Dec 2024 14:13:46","Close Bet","O2-DC-9D6WYY","T2-DC-5PE33M","O2-DC-9D6VN7","GBP/JPY","-","0.2","191.314","-","-","-","-","3,826.28","-2.10","100,374.57","-","-","-","-","-","-","-","-","-","-","-","-","-","-","-","-","-","-","-","-","-","-","-","-","-"
"04 Dec 2024 14:13:34","Close Bet","O2-DC-9D6WYN","T2-DC-5PE336","O2-DC-9D6W46","Gold - Cash","-","2","2,648.55","-","-","-","-","5,297.10","-0.40","100,376.67","-","-","-","-","-","-","-","-","-","-","-","-","-","-","-","-","-","-","-","-","-","-","-","-","-"
"04 Dec 2024 14:13:26","Close Bet","O2-DC-9D6WY6","T2-DC-5PE32X","O2-DC-9D6V4K","USD/CHF","-","1","0.88687","-","-","-","-","8,868.70","-0.20","100,377.07","-","-","-","-","-","-","-","-","-","-","-","-","-","-","-","-","-","-","-","-","-","-","-","-","-"
"04 Dec 2024 14:09:00","Close Bet","O2-DC-9D6WM2","T2-DC-5PE2SZ","O2-DC-9D6VBS","Crude Oil West Texas - Cash","-","0.3","70.269","-","-","-","-","2,108.07","-4.65","100,377.27","-","-","-","-","-","-","-","-","-","-","-","-","-","-","-","-","-","-","-","-","-","-","-","-","-"
"04 Dec 2024 14:01:20","Close Bet","O2-DC-9D6W6Y","T2-DC-5PE2E0","O2-DC-9D6W0Q","US 30 - Cash","-","0.1","44,884.08","-","-","-","-","4,488.40","-0.79","100,381.92","-","-","-","-","-","-","-","-","-","-","-","-","-","-","-","-","-","-","-","-","-","-","-","-","-"
"04 Dec 2024 13:52:50","Stop Loss","O2-DC-9D6VH3","T2-DC-5PE1YQ","-","US 30 - Cash","-","0.1","44,848.78","-","-","-","-","4,484.87","-6.90","100,382.71","-","-","-","-","-","-","-","-","-","-","-","-","-","-","-","-","-","-","-","-","-","-","-","-","-"
"04 Dec 2024 13:48:26","Close Bet","O2-DC-9D6VE7","T2-DC-5PE1RC","O2-DC-9D6V3N","US 30 - Cash","-","0.1","44,920.49","-","-","-","-","4,492.04","1.29","100,389.61","-","-","-","-","-","-","-","-","-","-","-","-","-","-","-","-","-","-","-","-","-","-","-","-","-"
"04 Dec 2024 13:48:26","Close Bet","O2-DC-9D6VE7","T2-DC-5PE1RB","O2-DC-9D6V2D","US 30 - Cash","-","0.1","44,920.49","-","-","-","-","4,492.04","1.50","100,388.32","-","-","-","-","-","-","-","-","-","-","-","-","-","-","-","-","-","-","-","-","-","-","-","-","-"
"04 Dec 2024 13:48:26","Close Bet","O2-DC-9D6VE7","T2-DC-5PE1R9","O2-DC-9D6PCJ","US 30 - Cash","-","0.5","44,920.49","-","-","-","-","22,460.24","0.86","100,386.82","-","-","-","-","-","-","-","-","-","-","-","-","-","-","-","-","-","-","-","-","-","-","-","-","-"
"04 Dec 2024 13:42:21","Close Bet","O2-DC-9D6V20","T2-DC-5PE1FN","O2-DC-9D6TZR","US 30 - Cash","-","0.1","44,896.22","-","-","-","-","4,489.62","-0.13","100,385.96","-","-","-","-","-","-","-","-","-","-","-","-","-","-","-","-","-","-","-","-","-","-","-","-","-"
"04 Dec 2024 13:25:47","Close Bet","O2-DC-9D6SW9","T2-DC-5PE0FB","O2-DC-9D6STQ","US 30 - Cash","-","0.2","44,879.23","-","-","-","-","8,975.84","-0.49","100,386.09","-","-","-","-","-","-","-","-","-","-","-","-","-","-","-","-","-","-","-","-","-","-","-","-","-"
"04 Dec 2024 08:55:11","Close Bet","O2-DC-9D6DQT","T2-DC-5PDNLT","O2-DC-9D5Y1W","Japan 225 - Cash","-","0.1","39,482.22","-","-","-","-","3,948.22","6.35","100,386.58","-","-","-","-","-","-","-","-","-","-","-","-","-","-","-","-","-","-","-","-","-","-","-","-","-"
"04 Dec 2024 08:54:56","Close Bet","O2-DC-9D6DQ5","T2-DC-5PDNLE","O2-DC-9D5W93","USD/CHF","-","1","0.88703","-","-","-","-","8,870.30","5.00","100,380.23","-","-","-","-","-","-","-","-","-","-","-","-","-","-","-","-","-","-","-","-","-","-","-","-","-"
"04 Dec 2024 00:17:39","Close Bet","O2-DC-9D5XXQ","T2-DC-5PD93X","O2-DC-9D5XTX","Japan 225 - Cash","-","0.3","39,360.25","-","-","-","-","11,808.07","-1.70","100,375.23","-","-","-","-","-","-","-","-","-","-","-","-","-","-","-","-","-","-","-","-","-","-","-","-","-"
"04 Dec 2024 00:13:43","Close Bet","O2-DC-9D5XTQ","T2-DC-5PD91L","O2-DC-9D5XSP","Japan 225 - Cash","-","0.3","39,358.91","-","-","-","-","11,807.67","9.90","100,376.93","-","-","-","-","-","-","-","-","-","-","-","-","-","-","-","-","-","-","-","-","-","-","-","-","-"
"04 Dec 2024 00:13:43","Close Bet","O2-DC-9D5XTQ","T2-DC-5PD91K","O2-DC-9D5XSF","Japan 225 - Cash","-","0.3","39,358.91","-","-","-","-","11,807.67","9.15","100,367.03","-","-","-","-","-","-","-","-","-","-","-","-","-","-","-","-","-","-","-","-","-","-","-","-","-"
"04 Dec 2024 00:07:58","Close Bet","O2-DC-9D5XPT","T2-DC-5PD8YV","O2-DC-9D5XKX","Japan 225 - Cash","-","0.3","39,276.41","-","-","-","-","11,782.92","-8.85","100,357.88","-","-","-","-","-","-","-","-","-","-","-","-","-","-","-","-","-","-","-","-","-","-","-","-","-"
"04 Dec 2024 00:07:58","Close Bet","O2-DC-9D5XPT","T2-DC-5PD8YT","O2-DC-9D5XJS","Japan 225 - Cash","-","0.3","39,276.41","-","-","-","-","11,782.92","-13.35","100,366.73","-","-","-","-","-","-","-","-","-","-","-","-","-","-","-","-","-","-","-","-","-","-","-","-","-"
"03 Dec 2024 23:23:43","Close Bet","O2-DC-9D5WN9","T2-DC-5PD865","O2-DC-9D5S9Y","Japan 225 - Cash","-","0.3","39,293.92","-","-","-","-","11,788.17","9.16","100,380.08","-","-","-","-","-","-","-","-","-","-","-","-","-","-","-","-","-","-","-","-","-","-","-","-","-"
"03 Dec 2024 23:22:10","Close Bet","O2-DC-9D5WLZ","T2-DC-5PD85B","O2-DC-9D5TZ9","Gold - Cash","-","2","2,641.58","-","-","-","-","5,283.16","-5.04","100,370.92","-","-","-","-","-","-","-","-","-","-","-","-","-","-","-","-","-","-","-","-","-","-","-","-","-"
"03 Dec 2024 21:28:11","Close Bet","O2-DC-9D5TVC","T2-DC-5PD6Y5","O2-DC-9D5TN9","US 30 - Cash","-","0.2","44,804.89","-","-","-","-","8,960.97","-7.76","100,377.86","-","-","-","-","-","-","-","-","-","-","-","-","-","-","-","-","-","-","-","-","-","-","-","-","-"
"03 Dec 2024 21:26:38","Close Bet","O2-DC-9D5TS8","T2-DC-5PD6W7","O2-DC-9D5SB9","USD/CHF","-","0.5","0.88606","-","-","-","-","4,430.30","-1.55","100,385.62","-","-","-","-","-","-","-","-","-","-","-","-","-","-","-","-","-","-","-","-","-","-","-","-","-"
"03 Dec 2024 21:26:38","Close Bet","O2-DC-9D5TS8","T2-DC-5PD6W6","O2-DC-9D5S92","USD/CHF","-","0.5","0.88606","-","-","-","-","4,430.30","-1.65","100,387.17","-","-","-","-","-","-","-","-","-","-","-","-","-","-","-","-","-","-","-","-","-","-","-","-","-"
"03 Dec 2024 21:26:38","Close Bet","O2-DC-9D5TS8","T2-DC-5PD6W5","O2-DC-9D5S8Q","USD/CHF","-","0.5","0.88606","-","-","-","-","4,430.30","-1.75","100,388.82","-","-","-","-","-","-","-","-","-","-","-","-","-","-","-","-","-","-","-","-","-","-","-","-","-"
"03 Dec 2024 21:11:59","Close Bet","O2-DC-9D5T9V","T2-DC-5PD6DP","O2-DC-9D5SY6","US 30 - Cash","-","0.2","44,768.36","-","-","-","-","8,953.67","-6.75","100,390.57","-","-","-","-","-","-","-","-","-","-","-","-","-","-","-","-","-","-","-","-","-","-","-","-","-"
"03 Dec 2024 21:11:59","Close Bet","O2-DC-9D5T9V","T2-DC-5PD6DN","O2-DC-9D5SXC","US 30 - Cash","-","0.2","44,768.36","-","-","-","-","8,953.67","-10.84","100,397.32","-","-","-","-","-","-","-","-","-","-","-","-","-","-","-","-","-","-","-","-","-","-","-","-","-"
"03 Dec 2024 21:11:59","Close Bet","O2-DC-9D5T9V","T2-DC-5PD6DM","O2-DC-9D5SV4","US 30 - Cash","-","0.2","44,768.36","-","-","-","-","8,953.67","-17.82","100,408.16","-","-","-","-","-","-","-","-","-","-","-","-","-","-","-","-","-","-","-","-","-","-","-","-","-"
"03 Dec 2024 20:49:37","Close Bet","O2-DC-9D5S8L","T2-DC-5PD5F0","O2-DC-9D5S8B","USD/CHF","-","0.2","0.88633","-","-","-","-","1,772.66","-0.20","100,425.98","-","-","-","-","-","-","-","-","-","-","-","-","-","-","-","-","-","-","-","-","-","-","-","-","-"
"03 Dec 2024 20:47:03","Close Bet","O2-DC-9D5S5H","T2-DC-5PD5CE","O2-DC-9D5RY5","US 30 - Cash","-","0.2","44,717.80","-","-","-","-","8,943.56","-0.35","100,426.18","-","-","-","-","-","-","-","-","-","-","-","-","-","-","-","-","-","-","-","-","-","-","-","-","-"
"03 Dec 2024 20:46:24","Close Bet","O2-DC-9D5S4G","T2-DC-5PD5BC","O2-DC-9D5RXQ","US 30 - Cash","-","0.2","44,704.30","-","-","-","-","8,940.86","1.76","100,426.53","-","-","-","-","-","-","-","-","-","-","-","-","-","-","-","-","-","-","-","-","-","-","-","-","-"
"03 Dec 2024 20:44:01","Close Bet","O2-DC-9D5S1S","T2-DC-5PD581","O2-DC-9D5RYH","US 30 - Cash","-","0.2","44,701.22","-","-","-","-","8,940.24","3.37","100,424.77","-","-","-","-","-","-","-","-","-","-","-","-","-","-","-","-","-","-","-","-","-","-","-","-","-"
"03 Dec 2024 19:32:15","Stop Loss","O2-DC-9D5MME","T2-DC-5PD3E5","-","US 30 - Cash","-","0.2","44,736.76","-","-","-","-","8,947.35","-0.76","100,421.40","-","-","-","-","-","-","-","-","-","-","-","-","-","-","-","-","-","-","-","-","-","-","-","-","-"
"03 Dec 2024 17:05:43","Close Bet","O2-DC-9D5HSJ","T2-DC-5PCY6C","O2-DC-9D5H6G","US 30 - Cash","-","0.2","44,630.04","-","-","-","-","8,926.00","6.90","100,422.16","-","-","-","-","-","-","-","-","-","-","-","-","-","-","-","-","-","-","-","-","-","-","-","-","-"
"03 Dec 2024 16:54:01","Close Bet","O2-DC-9D5H71","T2-DC-5PCXMP","O2-DC-9D5H62","US 30 - Cash","-","0.1","44,588.91","-","-","-","-","4,458.89","-0.67","100,415.26","-","-","-","-","-","-","-","-","-","-","-","-","-","-","-","-","-","-","-","-","-","-","-","-","-"
"03 Dec 2024 16:48:40","Close Bet","O2-DC-9D5GXG","T2-DC-5PCXB1","O2-DC-9D4TPK","USD/CAD","-","1","1.40722","-","-","-","-","14,072.20","26.70","100,415.93","-","-","-","-","-","-","-","-","-","-","-","-","-","-","-","-","-","-","-","-","-","-","-","-","-"
"03 Dec 2024 16:43:43","Close Bet","O2-DC-9D5GHW","T2-DC-5PCWYG","O2-DC-9D5FWS","US 30 - Cash","-","0.1","44,590.60","-","-","-","-","4,459.06","1.82","100,389.23","-","-","-","-","-","-","-","-","-","-","-","-","-","-","-","-","-","-","-","-","-","-","-","-","-"
"03 Dec 2024 16:43:43","Close Bet","O2-DC-9D5GHW","T2-DC-5PCWYF","O2-DC-9D5FW8","US 30 - Cash","-","0.1","44,590.60","-","-","-","-","4,459.06","2.12","100,387.41","-","-","-","-","-","-","-","-","-","-","-","-","-","-","-","-","-","-","-","-","-","-","-","-","-"
"03 Dec 2024 16:35:14","Close Bet","O2-DC-9D5FSK","T2-DC-5PCW9B","O2-DC-9D5CS8","USD/JPY","-","1","149.343","-","-","-","-","14,934.30","16.60","100,385.29","-","-","-","-","-","-","-","-","-","-","-","-","-","-","-","-","-","-","-","-","-","-","-","-","-"
"03 Dec 2024 16:27:17","Close Bet","O2-DC-9D5F0B","T2-DC-5PCVKL","O2-DC-9D5EN0","US 30 - Cash","-","0.1","44,637.40","-","-","-","-","4,463.74","-2.07","100,368.69","-","-","-","-","-","-","-","-","-","-","-","-","-","-","-","-","-","-","-","-","-","-","-","-","-"
"03 Dec 2024 16:27:17","Close Bet","O2-DC-9D5F0B","T2-DC-5PCVKK","O2-DC-9D5EMJ","US 30 - Cash","-","0.1","44,637.40","-","-","-","-","4,463.74","-1.66","100,370.76","-","-","-","-","-","-","-","-","-","-","-","-","-","-","-","-","-","-","-","-","-","-","-","-","-"
"03 Dec 2024 16:20:48","Close Bet","O2-DC-9D5EG7","T2-DC-5PCV2V","O2-DC-9D5DT6","US 30 - Cash","-","0.1","44,636.58","-","-","-","-","4,463.65","-0.75","100,372.42","-","-","-","-","-","-","-","-","-","-","-","-","-","-","-","-","-","-","-","-","-","-","-","-","-"
"03 Dec 2024 16:20:48","Close Bet","O2-DC-9D5EG7","T2-DC-5PCV2T","O2-DC-9D5DL4","US 30 - Cash","-","0.2","44,636.58","-","-","-","-","8,927.31","1.01","100,373.17","-","-","-","-","-","-","-","-","-","-","-","-","-","-","-","-","-","-","-","-","-","-","-","-","-"
"03 Dec 2024 16:09:02","Close Bet","O2-DC-9D5DNP","T2-DC-5PCTG4","O2-DC-9D576E","Crude Oil West Texas - Cash","-","0.1","69.764","-","-","-","-","697.64","4.56","100,372.16","-","-","-","-","-","-","-","-","-","-","-","-","-","-","-","-","-","-","-","-","-","-","-","-","-"
"03 Dec 2024 16:00:51","Close Bet","O2-DC-9D5CT2","T2-DC-5PCSQ5","O2-DC-9D56TM","Crude Oil West Texas - Cash","-","0.1","69.835","-","-","-","-","698.35","5.47","100,367.60","-","-","-","-","-","-","-","-","-","-","-","-","-","-","-","-","-","-","-","-","-","-","-","-","-"
"03 Dec 2024 15:55:18","Close Bet","O2-DC-9D5CB7","T2-DC-5PCS9R","O2-DC-9D59HB","Japan 225 - Cash","-","0.3","39,031.34","-","-","-","-","11,709.40","-0.60","100,362.13","-","-","-","-","-","-","-","-","-","-","-","-","-","-","-","-","-","-","-","-","-","-","-","-","-"
"03 Dec 2024 15:55:09","Close Bet","O2-DC-9D5C9Z","T2-DC-5PCS9H","O2-DC-9D59HY","USD/JPY","-","1","149.110","-","-","-","-","14,911.00","-4.10","100,362.73","-","-","-","-","-","-","-","-","-","-","-","-","-","-","-","-","-","-","-","-","-","-","-","-","-"
"03 Dec 2024 15:27:29","Close Bet","O2-DC-9D58G9","T2-DC-5PCPVT","O2-DC-9D4VXY","Copper - Cash","-","1","414.27","-","-","-","-","4,142.70","30.30","100,366.83","-","-","-","-","-","-","-","-","-","-","-","-","-","-","-","-","-","-","-","-","-","-","-","-","-"
"03 Dec 2024 15:22:58","Close Bet","O2-DC-9D57Z8","T2-DC-5PCPF3","O2-DC-9D54VV","USD/JPY","-","1","148.930","-","-","-","-","14,893.00","-2.20","100,336.53","-","-","-","-","-","-","-","-","-","-","-","-","-","-","-","-","-","-","-","-","-","-","-","-","-"
"03 Dec 2024 15:20:02","Close Bet","O2-DC-9D57H9","T2-DC-5PCP0D","O2-DC-9D52VP","Gold - Cash","-","2","2,637.67","-","-","-","-","5,275.34","-29.26","100,338.73","-","-","-","-","-","-","-","-","-","-","-","-","-","-","-","-","-","-","-","-","-","-","-","-","-"
"03 Dec 2024 15:19:00","Close Bet","O2-DC-9D57E3","T2-DC-5PCNXR","O2-DC-9D572G","Japan 225 - Cash","-","0.1","38,976.34","-","-","-","-","3,897.63","-3.45","100,367.99","-","-","-","-","-","-","-","-","-","-","-","-","-","-","-","-","-","-","-","-","-","-","-","-","-"
"03 Dec 2024 15:19:00","Close Bet","O2-DC-9D57E3","T2-DC-5PCNXQ","O2-DC-9D5684","Japan 225 - Cash","-","0.1","38,976.34","-","-","-","-","3,897.63","-7.70","100,371.44","-","-","-","-","-","-","-","-","-","-","-","-","-","-","-","-","-","-","-","-","-","-","-","-","-"
"03 Dec 2024 15:07:10","Close Bet","O2-DC-9D5627","T2-DC-5PCMSN","O2-DC-9D55T9","US NDAQ 100 - Cash","-","0.5","21,167.69","-","-","-","-","10,583.84","0.00","100,379.14","-","-","-","-","-","-","-","-","-","-","-","-","-","-","-","-","-","-","-","-","-","-","-","-","-"
"03 Dec 2024 15:06:28","Close Bet","O2-DC-9D55ZN","T2-DC-5PCMPX","O2-DC-9D54QJ","Japan 225 - Cash","-","1","39,043.83","-","-","-","-","39,043.83","30.50","100,379.14","-","-","-","-","-","-","-","-","-","-","-","-","-","-","-","-","-","-","-","-","-","-","-","-","-"
"03 Dec 2024 14:58:33","Close Bet","O2-DC-9D54N7","T2-DC-5PCLJH","O2-DC-9D518L","Japan 225 - Dec 2024","-","0.3","39,005.0","-","-","-","-","11,701.50","-15.75","100,348.64","-","-","-","-","-","-","-","-","-","-","-","-","-","-","-","-","-","-","-","-","-","-","-","-","-"
"03 Dec 2024 14:39:45","Close Bet","O2-DC-9D52M6","T2-DC-5PCJVT","O2-DC-9D4WBG","Gold - Cash","-","5","2,650.27","-","-","-","-","13,251.35","38.55","100,364.39","-","-","-","-","-","-","-","-","-","-","-","-","-","-","-","-","-","-","-","-","-","-","-","-","-"
"03 Dec 2024 14:39:45","Close Bet","O2-DC-9D52M6","T2-DC-5PCJVS","O2-DC-9D4N9W","Gold - Cash","-","2","2,650.27","-","-","-","-","5,300.54","7.70","100,325.84","-","-","-","-","-","-","-","-","-","-","-","-","-","-","-","-","-","-","-","-","-","-","-","-","-"
"03 Dec 2024 14:39:30","Close Bet","O2-DC-9D52L3","T2-DC-5PCJV9","O2-DC-9D52EH","US 30 - Cash","-","0.5","44,723.17","-","-","-","-","22,361.58","5.05","100,318.14","-","-","-","-","-","-","-","-","-","-","-","-","-","-","-","-","-","-","-","-","-","-","-","-","-"
"03 Dec 2024 14:38:46","Close Bet","O2-DC-9D52H9","T2-DC-5PCJS4","O2-DC-9D5131","US 30 - Cash","-","0.5","44,724.68","-","-","-","-","22,362.34","-55.81","100,313.09","-","-","-","-","-","-","-","-","-","-","-","-","-","-","-","-","-","-","-","-","-","-","-","-","-"
"03 Dec 2024 14:37:04","Close Bet","O2-DC-9D527D","T2-DC-5PCJHN","O2-DC-9D525Z","US 30 - Cash","-","0.5","44,739.73","-","-","-","-","22,369.86","-6.79","100,368.90","-","-","-","-","-","-","-","-","-","-","-","-","-","-","-","-","-","-","-","-","-","-","-","-","-"
"03 Dec 2024 14:31:06","Close Bet","O2-DC-9D515G","T2-DC-5PCHN7","O2-DC-9D4XP1","Crude Oil West Texas - Cash","-","1","69.213","-","-","-","-","6,921.30","-23.80","100,375.69","-","-","-","-","-","-","-","-","-","-","-","-","-","-","-","-","-","-","-","-","-","-","-","-","-"
"03 Dec 2024 14:30:06","Close Bet","O2-DC-9D50Z6","T2-DC-5PCHG9","O2-DC-9D4WJ9","US 30 - Cash","-","2","44,863.50","-","-","-","-","89,727.00","157.94","100,399.49","-","-","-","-","-","-","-","-","-","-","-","-","-","-","-","-","-","-","-","-","-","-","-","-","-"
"03 Dec 2024 13:30:33","Close Bet","O2-DC-9D4X1V","T2-DC-5PCE1X","O2-DC-9D4WZN","Crude Oil West Texas - Cash","-","1","69.311","-","-","-","-","6,931.10","-1.00","100,241.55","-","-","-","-","-","-","-","-","-","-","-","-","-","-","-","-","-","-","-","-","-","-","-","-","-"
"03 Dec 2024 13:26:53","Close Bet","O2-DC-9D4WYC","T2-DC-5PCDYW","O2-DC-9D4W8C","Japan 225 - Cash","-","0.1","39,133.31","-","-","-","-","3,913.33","4.80","100,242.55","-","-","-","-","-","-","-","-","-","-","-","-","-","-","-","-","-","-","-","-","-","-","-","-","-"
"03 Dec 2024 13:26:42","Close Bet","O2-DC-9D4WY1","T2-DC-5PCDYL","O2-DC-9D4WFZ","Japan 225 - Cash","-","2.9","39,133.31","-","-","-","-","113,486.59","146.42","100,237.75","-","-","-","-","-","-","-","-","-","-","-","-","-","-","-","-","-","-","-","-","-","-","-","-","-"
"03 Dec 2024 13:13:50","Close Bet","O2-DC-9D4WFE","T2-DC-5PCD6C","O2-DC-9D4W9Z","Crude Oil West Texas - Cash","-","1","69.531","-","-","-","-","6,953.10","-5.10","100,091.33","-","-","-","-","-","-","-","-","-","-","-","-","-","-","-","-","-","-","-","-","-","-","-","-","-"
"03 Dec 2024 13:09:52","Close Bet","O2-DC-9D4W8Y","T2-DC-5PCD26","O2-DC-9D4W58","Crude Oil West Texas - Cash","-","1","69.511","-","-","-","-","6,951.10","-2.00","100,096.43","-","-","-","-","-","-","-","-","-","-","-","-","-","-","-","-","-","-","-","-","-","-","-","-","-"
"03 Dec 2024 13:06:21","Close Bet","O2-DC-9D4W4C","T2-DC-5PCCY6","O2-DC-9D4VYM","Japan 225 - Cash","-","2","39,191.30","-","-","-","-","78,382.60","21.00","100,098.43","-","-","-","-","-","-","-","-","-","-","-","-","-","-","-","-","-","-","-","-","-","-","-","-","-"
"03 Dec 2024 12:29:16","Close Bet","O2-DC-9D4TQ6","T2-DC-5PCBRZ","O2-DC-9D4L3R","Gold - Cash","-","5","2,639.14","-","-","-","-","13,195.70","-37.15","100,077.43","-","-","-","-","-","-","-","-","-","-","-","-","-","-","-","-","-","-","-","-","-","-","-","-","-"
"03 Dec 2024 12:28:57","Close Bet","O2-DC-9D4TPK","T2-DC-5PCBR9","O2-DC-9D4LBV","USD/CAD","-","1","1.40455","-","-","-","-","14,045.50","-35.00","100,114.58","-","-","-","-","-","-","-","-","-","-","-","-","-","-","-","-","-","-","-","-","-","-","-","-","-"
"03 Dec 2024 10:50:29","Close Bet","O2-DC-9D4QC6","T2-DC-5PC80P","O2-DC-9D4L67","US 30 - Cash","-","0.2","44,761.59","-","-","-","-","8,952.31","-8.06","100,149.58","-","-","-","-","-","-","-","-","-","-","-","-","-","-","-","-","-","-","-","-","-","-","-","-","-"
"03 Dec 2024 08:18:49","Close Bet","O2-DC-9D4H05","T2-DC-5PC20D","O2-DC-9D480S","USD/CHF","-","2","0.88685","-","-","-","-","17,737.00","-24.20","100,157.64","-","-","-","-","-","-","-","-","-","-","-","-","-","-","-","-","-","-","-","-","-","-","-","-","-"
"03 Dec 2024 08:17:55","Close Bet","O2-DC-9D4GX8","T2-DC-5PC1XE","O2-DC-9D47ZG","GBP/JPY","-","0.5","190.315","-","-","-","-","9,515.75","34.45","100,181.84","-","-","-","-","-","-","-","-","-","-","-","-","-","-","-","-","-","-","-","-","-","-","-","-","-"
"03 Dec 2024 08:17:34","Close Bet","O2-DC-9D4GW3","T2-DC-5PC1WK","O2-DC-9D44ZK","Crude Oil West Texas - Cash","-","1","68.710","-","-","-","-","6,871.00","34.10","100,147.39","-","-","-","-","-","-","-","-","-","-","-","-","-","-","-","-","-","-","-","-","-","-","-","-","-"
"03 Dec 2024 08:17:34","Close Bet","O2-DC-9D4GW3","T2-DC-5PC1WJ","O2-DC-9D44Q3","Crude Oil West Texas - Cash","-","2","68.710","-","-","-","-","13,742.00","65.20","100,113.29","-","-","-","-","-","-","-","-","-","-","-","-","-","-","-","-","-","-","-","-","-","-","-","-","-"
"03 Dec 2024 08:17:34","Close Bet","O2-DC-9D4GW3","T2-DC-5PC1WH","O2-DC-9D44PX","Crude Oil West Texas - Cash","-","1","68.710","-","-","-","-","6,871.00","32.10","100,048.09","-","-","-","-","-","-","-","-","-","-","-","-","-","-","-","-","-","-","-","-","-","-","-","-","-"
"03 Dec 2024 03:41:47","Close Bet","O2-DC-9D487E","T2-DC-5PBVEQ","O2-DC-9D3LXF","GBP/USD","-","0.5","1.26474","-","-","-","-","6,323.70","-1.35","100,015.99","-","-","-","-","-","-","-","-","-","-","-","-","-","-","-","-","-","-","-","-","-","-","-","-","-"
"03 Dec 2024 03:40:02","Close Bet","O2-DC-9D485V","T2-DC-5PBVD5","O2-DC-9D481D","Japan 225 - Cash","-","5","39,267.09","-","-","-","-","196,335.45","90.00","100,017.34","-","-","-","-","-","-","-","-","-","-","-","-","-","-","-","-","-","-","-","-","-","-","-","-","-"
"03 Dec 2024 02:31:35","Close Bet","O2-DC-9D46SM","T2-DC-5PBT8M","O2-DC-9D44PX","Crude Oil West Texas - Cash","-","1","68.128","-","-","-","-","6,812.80","-26.10","99,927.34","-","-","-","-","-","-","-","-","-","-","-","-","-","-","-","-","-","-","-","-","-","-","-","-","-"
"03 Dec 2024 01:39:52","Close Bet","O2-DC-9D45RV","T2-DC-5PBSES","O2-DC-9D455M","Japan 225 - Cash","-","1","39,124.77","-","-","-","-","39,124.77","120.83","99,953.44","-","-","-","-","-","-","-","-","-","-","-","-","-","-","-","-","-","-","-","-","-","-","-","-","-"
"03 Dec 2024 01:06:26","Stop Loss","O2-DC-9D43RB","T2-DC-5PBRM7","-","GBP/JPY","-","1","189.420","-","-","-","-","18,942.00","-7.70","99,832.61","-","-","-","-","-","-","-","-","-","-","-","-","-","-","-","-","-","-","-","-","-","-","-","-","-"
"03 Dec 2024 01:06:05","Stop Loss","O2-DC-9D44PB","T2-DC-5PBRLN","-","Japan 225 - Cash","-","1","38,927.13","-","-","-","-","38,927.13","-106.85","99,840.31","-","-","-","-","-","-","-","-","-","-","-","-","-","-","-","-","-","-","-","-","-","-","-","-","-"
"03 Dec 2024 00:47:08","Close Bet","O2-DC-9D44G5","T2-DC-5PBRBF","O2-DC-9D43KT","Japan 225 - Cash","-","1","39,029.88","-","-","-","-","39,029.88","45.66","99,947.16","-","-","-","-","-","-","-","-","-","-","-","-","-","-","-","-","-","-","-","-","-","-","-","-","-"
"03 Dec 2024 00:42:58","Stop Loss","O2-DC-9D4498","T2-DC-5PBR69","-","Japan 225 - Cash","-","1","38,968.12","-","-","-","-","38,968.12","-11.45","99,901.50","-","-","-","-","-","-","-","-","-","-","-","-","-","-","-","-","-","-","-","-","-","-","-","-","-"
"03 Dec 2024 00:05:50","Close Bet","O2-DC-9D43HH","T2-DC-5PBQJS","O2-DC-9D43F1","Japan 225 - Cash","-","1","38,967.22","-","-","-","-","38,967.22","30.50","99,912.95","-","-","-","-","-","-","-","-","-","-","-","-","-","-","-","-","-","-","-","-","-","-","-","-","-"
"03 Dec 2024 00:05:50","Close Bet","O2-DC-9D43HH","T2-DC-5PBQJR","O2-DC-9D43EL","Japan 225 - Cash","-","1","38,967.22","-","-","-","-","38,967.22","30.50","99,882.45","-","-","-","-","-","-","-","-","-","-","-","-","-","-","-","-","-","-","-","-","-","-","-","-","-"
"02 Dec 2024 16:27:01","Close Bet","O2-DC-9D3LRG","T2-DC-5PBBSW","O2-DC-9D2ZHL","GBP/JPY","-","1","188.756","-","-","-","-","18,875.60","150.00","99,852.14","-","-","-","-","-","-","-","-","-","-","-","-","-","-","-","-","-","-","-","-","-","-","-","-","-"
"02 Dec 2024 16:26:31","Close Bet","O2-DC-9D3LQ3","T2-DC-5PBBS1","O2-DC-9D2ZT9","Gold - Cash","-","10","2,642.52","-","-","-","-","26,425.20","-13.00","99,702.14","-","-","-","-","-","-","-","-","-","-","-","-","-","-","-","-","-","-","-","-","-","-","-","-","-"
"02 Dec 2024 14:26:38","Close Bet","O2-DC-9D351D","T2-DC-5P9XHB","O2-DC-9D2SB7","Crude Oil West Texas - Cash","-","2","68.999","-","-","-","-","13,799.80","41.00","99,715.14","-","-","-","-","-","-","-","-","-","-","-","-","-","-","-","-","-","-","-","-","-","-","-","-","-"
"02 Dec 2024 12:55:38","Close Bet","O2-DC-9D2ZQ6","T2-DC-5P9RYM","O2-DC-9D2B85","Japan 225 - Cash","-","1","38,607.09","-","-","-","-","38,607.09","99.39","99,674.14","-","-","-","-","-","-","-","-","-","-","-","-","-","-","-","-","-","-","-","-","-","-","-","-","-"
"02 Dec 2024 12:55:06","Close Bet","O2-DC-9D2ZPB","T2-DC-5P9RXQ","O2-DC-9D2Q1Y","Gold - Cash","-","10","2,640.76","-","-","-","-","26,407.60","41.40","99,574.75","-","-","-","-","-","-","-","-","-","-","-","-","-","-","-","-","-","-","-","-","-","-","-","-","-"
"02 Dec 2024 12:39:02","Stop Loss","O2-DC-9D2Q44","T2-DC-5P9R4C","-","GBP/JPY","-","1","190.389","-","-","-","-","19,038.90","-60.20","99,533.35","-","-","-","-","-","-","-","-","-","-","-","-","-","-","-","-","-","-","-","-","-","-","-","-","-"
"02 Dec 2024 03:38:05","Close Bet","O2-DC-9D29QL","T2-DC-5P96CK","O2-DC-9D298Z","Gold - Cash","-","5","2,625.18","-","-","-","-","13,125.90","-14.80","99,593.55","-","-","-","-","-","-","-","-","-","-","-","-","-","-","-","-","-","-","-","-","-","-","-","-","-"
"02 Dec 2024 03:37:59","Close Bet","O2-DC-9D29QJ","T2-DC-5P96CJ","O2-DC-9D29P1","Japan 225 - Cash","-","2","38,271.04","-","-","-","-","76,542.08","-49.00","99,608.35","-","-","-","-","-","-","-","-","-","-","-","-","-","-","-","-","-","-","-","-","-","-","-","-","-"
"02 Dec 2024 03:37:02","Close Bet","O2-DC-9D29PR","T2-DC-5P96C3","O2-DC-9D29P1","Japan 225 - Cash","-","4","38,248.54","-","-","-","-","152,994.16","-8.00","99,657.35","-","-","-","-","-","-","-","-","-","-","-","-","-","-","-","-","-","-","-","-","-","-","-","-","-"
"02 Dec 2024 03:37:02","Close Bet","O2-DC-9D29PR","T2-DC-5P96C2","O2-DC-9D29N4","Japan 225 - Cash","-","2","38,248.54","-","-","-","-","76,497.08","1.00","99,665.35","-","-","-","-","-","-","-","-","-","-","-","-","-","-","-","-","-","-","-","-","-","-","-","-","-"
"02 Dec 2024 03:34:03","Stop Loss","O2-DC-9D29NC","T2-DC-5P96B8","-","Japan 225 - Cash","-","6","38,255.70","-","-","-","-","229,534.20","-99.96","99,664.35","-","-","-","-","-","-","-","-","-","-","-","-","-","-","-","-","-","-","-","-","-","-","-","-","-"
"02 Dec 2024 03:33:15","Close Bet","O2-DC-9D29MX","T2-DC-5P969R","O2-DC-9D29KV","Japan 225 - Cash","-","2","38,263.54","-","-","-","-","76,527.08","-4.00","99,764.31","-","-","-","-","-","-","-","-","-","-","-","-","-","-","-","-","-","-","-","-","-","-","-","-","-"
"02 Dec 2024 03:33:15","Close Bet","O2-DC-9D29MX","T2-DC-5P969Q","O2-DC-9D29KC","Japan 225 - Cash","-","2","38,263.54","-","-","-","-","76,527.08","26.00","99,768.31","-","-","-","-","-","-","-","-","-","-","-","-","-","-","-","-","-","-","-","-","-","-","-","-","-"
"02 Dec 2024 03:33:15","Close Bet","O2-DC-9D29MX","T2-DC-5P969P","O2-DC-9D29J1","Japan 225 - Cash","-","2","38,263.54","-","-","-","-","76,527.08","46.00","99,742.31","-","-","-","-","-","-","-","-","-","-","-","-","-","-","-","-","-","-","-","-","-","-","-","-","-"
"02 Dec 2024 03:22:59","Close Bet","O2-DC-9D29CJ","T2-DC-5P963P","O2-DC-9D296N","Japan 225 - Cash","-","2","38,298.54","-","-","-","-","76,597.08","-69.00","99,696.31","-","-","-","-","-","-","-","-","-","-","-","-","-","-","-","-","-","-","-","-","-","-","-","-","-"
"02 Dec 2024 03:22:50","Close Bet","O2-DC-9D29C6","T2-DC-5P963B","O2-DC-9D296F","Japan 225 - Cash","-","2","38,291.04","-","-","-","-","76,582.08","-54.00","99,765.31","-","-","-","-","-","-","-","-","-","-","-","-","-","-","-","-","-","-","-","-","-","-","-","-","-"
"02 Dec 2024 03:22:42","Close Bet","O2-DC-9D29C0","T2-DC-5P9636","O2-DC-9D2969","Japan 225 - Cash","-","2","38,286.04","-","-","-","-","76,572.08","-34.00","99,819.31","-","-","-","-","-","-","-","-","-","-","-","-","-","-","-","-","-","-","-","-","-","-","-","-","-"
"02 Dec 2024 03:22:17","Close Bet","O2-DC-9D29BM","T2-DC-5P9630","O2-DC-9D293Z","Japan 225 - Cash","-","2","38,276.04","-","-","-","-","76,552.08","-9.00","99,853.31","-","-","-","-","-","-","-","-","-","-","-","-","-","-","-","-","-","-","-","-","-","-","-","-","-"
"02 Dec 2024 03:16:27","Close Bet","O2-DC-9D2950","T2-DC-5P95XN","O2-DC-9D293P","Japan 225 - Cash","-","2","38,288.54","-","-","-","-","76,577.08","-24.00","99,862.31","-","-","-","-","-","-","-","-","-","-","-","-","-","-","-","-","-","-","-","-","-","-","-","-","-"
"02 Dec 2024 03:13:06","Close Bet","O2-DC-9D292F","T2-DC-5P95VC","O2-DC-9D291M","Japan 225 - Cash","-","2","38,296.04","-","-","-","-","76,592.08","-29.00","99,886.31","-","-","-","-","-","-","-","-","-","-","-","-","-","-","-","-","-","-","-","-","-","-","-","-","-"
"02 Dec 2024 03:10:24","Close Bet","O2-DC-9D28ZM","T2-DC-5P95SK","O2-DC-9D28W8","Japan 225 - Cash","-","2","38,291.04","-","-","-","-","76,582.08","1.00","99,915.31","-","-","-","-","-","-","-","-","-","-","-","-","-","-","-","-","-","-","-","-","-","-","-","-","-"
"02 Dec 2024 03:09:46","Close Bet","O2-DC-9D28Z6","T2-DC-5P95S7","O2-DC-9D28VL","Japan 225 - Cash","-","2","38,291.04","-","-","-","-","76,582.08","11.00","99,914.31","-","-","-","-","-","-","-","-","-","-","-","-","-","-","-","-","-","-","-","-","-","-","-","-","-"
"02 Dec 2024 03:09:18","Close Bet","O2-DC-9D28YL","T2-DC-5P95RY","O2-DC-9D28TH","Japan 225 - Cash","-","2","38,288.54","-","-","-","-","76,577.08","26.00","99,903.31","-","-","-","-","-","-","-","-","-","-","-","-","-","-","-","-","-","-","-","-","-","-","-","-","-"
"02 Dec 2024 03:05:30","Close Bet","O2-DC-9D28V1","T2-DC-5P95PB","O2-DC-9D28SZ","Japan 225 - Cash","-","2","38,311.04","-","-","-","-","76,622.08","-19.00","99,877.31","-","-","-","-","-","-","-","-","-","-","-","-","-","-","-","-","-","-","-","-","-","-","-","-","-"
"02 Dec 2024 03:01:52","Close Bet","O2-DC-9D28QR","T2-DC-5P95LR","O2-DC-9D28P1","Japan 225 - Cash","-","2","38,321.04","-","-","-","-","76,642.08","-59.00","99,896.31","-","-","-","-","-","-","-","-","-","-","-","-","-","-","-","-","-","-","-","-","-","-","-","-","-"
"02 Dec 2024 03:01:27","Close Bet","O2-DC-9D28QG","T2-DC-5P95LK","O2-DC-9D28NS","Japan 225 - Cash","-","2","38,316.04","-","-","-","-","76,632.08","-64.00","99,955.31","-","-","-","-","-","-","-","-","-","-","-","-","-","-","-","-","-","-","-","-","-","-","-","-","-"
"02 Dec 2024 02:55:02","Close Bet","O2-DC-9D28KB","T2-DC-5P95G8","O2-DC-9D28JT","Japan 225 - Cash","-","2","38,281.04","-","-","-","-","76,562.08","-34.00","100,019.31","-","-","-","-","-","-","-","-","-","-","-","-","-","-","-","-","-","-","-","-","-","-","-","-","-"
"02 Dec 2024 02:54:40","Close Bet","O2-DC-9D28K5","T2-DC-5P95G6","O2-DC-9D28JG","Japan 225 - Cash","-","2","38,276.04","-","-","-","-","76,552.08","-14.00","100,053.31","-","-","-","-","-","-","-","-","-","-","-","-","-","-","-","-","-","-","-","-","-","-","-","-","-"
"02 Dec 2024 02:45:37","Close Bet","O2-DC-9D28DX","T2-DC-5P95CN","O2-DC-9D289N","Japan 225 - Cash","-","1","38,266.04","-","-","-","-","38,266.04","-24.50","100,067.31","-","-","-","-","-","-","-","-","-","-","-","-","-","-","-","-","-","-","-","-","-","-","-","-","-"
"02 Dec 2024 02:45:37","Close Bet","O2-DC-9D28DX","T2-DC-5P95CM","O2-DC-9D289K","Japan 225 - Cash","-","1","38,266.04","-","-","-","-","38,266.04","-24.50","100,091.81","-","-","-","-","-","-","-","-","-","-","-","-","-","-","-","-","-","-","-","-","-","-","-","-","-"
"02 Dec 2024 02:38:23","Close Bet","O2-DC-9D288X","T2-DC-5P958Q","O2-DC-9D2882","Japan 225 - Cash","-","1","38,268.54","-","-","-","-","38,268.54","-27.00","100,116.31","-","-","-","-","-","-","-","-","-","-","-","-","-","-","-","-","-","-","-","-","-","-","-","-","-"
"02 Dec 2024 02:38:15","Close Bet","O2-DC-9D288S","T2-DC-5P958N","O2-DC-9D285P","Japan 225 - Cash","-","1","38,256.04","-","-","-","-","38,256.04","-14.50","100,143.31","-","-","-","-","-","-","-","-","-","-","-","-","-","-","-","-","-","-","-","-","-","-","-","-","-"
"02 Dec 2024 02:36:36","Close Bet","O2-DC-9D287C","T2-DC-5P957D","O2-DC-9D285G","Japan 225 - Cash","-","1","38,261.04","-","-","-","-","38,261.04","-19.50","100,157.81","-","-","-","-","-","-","-","-","-","-","-","-","-","-","-","-","-","-","-","-","-","-","-","-","-"
"02 Dec 2024 02:36:29","Close Bet","O2-DC-9D2877","T2-DC-5P957C","O2-DC-9D284Z","Japan 225 - Cash","-","1","38,253.54","-","-","-","-","38,253.54","-9.50","100,177.31","-","-","-","-","-","-","-","-","-","-","-","-","-","-","-","-","-","-","-","-","-","-","-","-","-"
"02 Dec 2024 02:33:13","Close Bet","O2-DC-9D284C","T2-DC-5P9558","O2-DC-9D27RR","Japan 225 - Cash","-","1","38,261.04","-","-","-","-","38,261.04","-31.04","100,186.81","-","-","-","-","-","-","-","-","-","-","-","-","-","-","-","-","-","-","-","-","-","-","-","-","-"
"02 Dec 2024 00:35:05","Stop Loss","O2-DC-9D0GPG","T2-DC-5P9235","-","Gold - Cash","-","2","2,640.77","-","-","-","-","5,281.54","-34.52","100,217.85","-","-","-","-","-","-","-","-","-","-","-","-","-","-","-","-","-","-","-","-","-","-","-","-","-"
"29 Nov 2024 16:45:39","Stop Loss","O2-DC-9D14HN","T2-DC-5P8QDW","-","Crude Oil West Texas - Cash","-","1","69.121","-","-","-","-","6,912.10","3.50","100,253.24","-","-","-","-","-","-","-","-","-","-","-","-","-","-","-","-","-","-","-","-","-","-","-","-","-"
"29 Nov 2024 15:21:10","Close Bet","O2-DC-9D1HME","T2-DC-5P8JCW","O2-DC-9D14MB","Euro 50 - Cash","-","2","4,782.6","-","-","-","-","9,565.20","20.00","100,249.74","-","-","-","-","-","-","-","-","-","-","-","-","-","-","-","-","-","-","-","-","-","-","-","-","-"
"29 Nov 2024 15:20:59","Close Bet","O2-DC-9D1HLT","T2-DC-5P8JCJ","O2-DC-9D0GR6","USD/CHF","-","0.2","0.88204","-","-","-","-","1,764.08","-1.36","100,229.74","-","-","-","-","-","-","-","-","-","-","-","-","-","-","-","-","-","-","-","-","-","-","-","-","-"
"29 Nov 2024 15:19:06","Close Bet","O2-DC-9D1HG2","T2-DC-5P8J7X","O2-DC-9CYC2Q","Soybean - Cash","-","1","978.59","-","-","-","-","978.59","-10.85","100,231.10","-","-","-","-","-","-","-","-","-","-","-","-","-","-","-","-","-","-","-","-","-","-","-","-","-"
"29 Nov 2024 14:59:01","Stop Loss","O2-DC-9D14X1","T2-DC-5P8G12","-","USD/CAD","-","2","1.40151","-","-","-","-","28,030.20","-5.20","100,241.95","-","-","-","-","-","-","-","-","-","-","-","-","-","-","-","-","-","-","-","-","-","-","-","-","-"
"29 Nov 2024 08:58:26","Close Bet","O2-DC-9D0VR9","T2-DC-5P7ZFB","O2-DC-9D0GJY","Crude Oil West Texas - Cash","-","1","68.705","-","-","-","-","6,870.50","-58.20","100,247.15","-","-","-","-","-","-","-","-","-","-","-","-","-","-","-","-","-","-","-","-","-","-","-","-","-"
"29 Nov 2024 03:03:48","Close Bet","O2-DC-9D0H36","T2-DC-5P7NTQ","O2-DC-9CX1W3","USD/CAD","-","2","1.39931","-","-","-","-","27,986.20","-63.80","100,305.35","-","-","-","-","-","-","-","-","-","-","-","-","-","-","-","-","-","-","-","-","-","-","-","-","-"
"28 Nov 2024 16:12:56","Stop Loss","O2-DC-9CZQD3","T2-DC-5P7D6S","-","Crude Oil West Texas - Cash","-","0.4","68.842","-","-","-","-","2,753.68","0.32","100,369.35","-","-","-","-","-","-","-","-","-","-","-","-","-","-","-","-","-","-","-","-","-","-","-","-","-"
"27 Nov 2024 18:21:18","Close Bet","O2-DC-9CYYR4","T2-DC-5P6DF2","O2-DC-9CYVLV","US NDAQ 100 - Cash","-","0.5","20,713.77","-","-","-","-","10,356.88","26.70","100,369.22","-","-","-","-","-","-","-","-","-","-","-","-","-","-","-","-","-","-","-","-","-","-","-","-","-"
"27 Nov 2024 17:08:04","Close Bet","O2-DC-9CYTQT","T2-DC-5P68XD","O2-DC-9CYPW2","US NDAQ 100 - Cash","-","0.5","20,629.82","-","-","-","-","10,314.91","-17.35","100,342.52","-","-","-","-","-","-","-","-","-","-","-","-","-","-","-","-","-","-","-","-","-","-","-","-","-"
"27 Nov 2024 16:10:08","Stop Loss","O2-DC-9CYLTN","T2-DC-5P655B","-","Crude Oil West Texas - Cash","-","1","69.227","-","-","-","-","6,922.70","20.60","100,359.87","-","-","-","-","-","-","-","-","-","-","-","-","-","-","-","-","-","-","-","-","-","-","-","-","-"
"27 Nov 2024 15:16:36","Close Bet","O2-DC-9CYHF0","T2-DC-5P600V","O2-DC-9CYGBR","Crude Oil West Texas - Cash","-","1","69.056","-","-","-","-","6,905.60","-31.60","100,339.27","-","-","-","-","-","-","-","-","-","-","-","-","-","-","-","-","-","-","-","-","-","-","-","-","-"
"27 Nov 2024 13:26:04","Close Bet","O2-DC-9CY60Y","T2-DC-5P5PS0","O2-DC-9CY1X3","US 30 - Cash","-","0.3","44,880.71","-","-","-","-","13,464.21","16.27","100,370.87","-","-","-","-","-","-","-","-","-","-","-","-","-","-","-","-","-","-","-","-","-","-","-","-","-"
"27 Nov 2024 11:11:56","Close Bet","O2-DC-9CY0VY","T2-DC-5P5KLW","O2-DC-9CY0VB","US 30 - Cash","-","0.3","44,822.28","-","-","-","-","13,446.68","-3.29","100,354.60","-","-","-","-","-","-","-","-","-","-","-","-","-","-","-","-","-","-","-","-","-","-","-","-","-"
"27 Nov 2024 11:02:00","Close Bet","O2-DC-9CY0HJ","T2-DC-5P5KCY","O2-DC-9CY046","US 30 - Cash","-","2","44,842.41","-","-","-","-","89,684.82","27.76","100,357.89","-","-","-","-","-","-","-","-","-","-","-","-","-","-","-","-","-","-","-","-","-","-","-","-","-"
"27 Nov 2024 08:19:59","Take Profit","O2-DC-9CWWP7","T2-DC-5P5B41","-","Gold - Cash","-","1","2,649.00","-","-","-","-","2,649.00","26.24","100,330.13","-","-","-","-","-","-","-","-","-","-","-","-","-","-","-","-","-","-","-","-","-","-","-","-","-"
"26 Nov 2024 23:53:11","Close Bet","O2-DC-9CX7HY","T2-DC-5P4X3W","O2-DC-9CX15M","AUD/USD","-","2","0.64736","-","-","-","-","12,947.20","34.00","100,303.89","-","-","-","-","-","-","-","-","-","-","-","-","-","-","-","-","-","-","-","-","-","-","-","-","-"
"26 Nov 2024 20:59:05","Close Bet","O2-DC-9CX4LS","T2-DC-5P4TZX","O2-DC-9CX4HL","US NDAQ 100 - Cash","-","2","20,922.23","-","-","-","-","41,844.46","0.68","100,270.84","-","-","-","-","-","-","-","-","-","-","-","-","-","-","-","-","-","-","-","-","-","-","-","-","-"
"26 Nov 2024 19:53:50","Stop Loss","O2-DC-9CX0GW","T2-DC-5P4R11","-","Crude Oil West Texas - Cash","-","1","68.875","-","-","-","-","6,887.50","-21.50","100,270.16","-","-","-","-","-","-","-","-","-","-","-","-","-","-","-","-","-","-","-","-","-","-","-","-","-"
"26 Nov 2024 19:35:03","Close Bet","O2-DC-9CX0D3","T2-DC-5P4Q6H","O2-DC-9CWZRT","Crude Oil West Texas - Cash","-","2","69.045","-","-","-","-","13,809.00","29.00","100,291.66","-","-","-","-","-","-","-","-","-","-","-","-","-","-","-","-","-","-","-","-","-","-","-","-","-"
"26 Nov 2024 19:25:46","Close Bet","O2-DC-9CWZTH","T2-DC-5P4PQR","O2-DC-9CWYK3","AUD/USD","-","2","0.64500","-","-","-","-","12,900.00","-14.00","100,262.66","-","-","-","-","-","-","-","-","-","-","-","-","-","-","-","-","-","-","-","-","-","-","-","-","-"
"26 Nov 2024 19:23:27","Close Bet","O2-DC-9CWZN9","T2-DC-5P4PKL","O2-DC-9CWWL4","US NDAQ 100 - Cash","-","1","20,857.48","-","-","-","-","20,857.48","17.99","100,276.66","-","-","-","-","-","-","-","-","-","-","-","-","-","-","-","-","-","-","-","-","-","-","-","-","-"
"26 Nov 2024 19:22:20","Stop Loss","O2-DC-9CWYZW","T2-DC-5P4PH5","-","Crude Oil West Texas - Cash","-","2","68.745","-","-","-","-","13,749.00","-16.80","100,258.67","-","-","-","-","-","-","-","-","-","-","-","-","-","-","-","-","-","-","-","-","-","-","-","-","-"
"26 Nov 2024 19:20:15","Stop Loss","O2-DC-9CWZ0J","T2-DC-5P4PCV","-","US 30 - Cash","-","2","44,709.99","-","-","-","-","89,419.98","18.12","100,275.47","-","-","-","-","-","-","-","-","-","-","-","-","-","-","-","-","-","-","-","-","-","-","-","-","-"
"26 Nov 2024 19:12:11","Close Bet","O2-DC-9CWYXQ","T2-DC-5P4NV0","O2-DC-9CWYWV","Crude Oil West Texas - Cash","-","0.5","68.729","-","-","-","-","3,436.45","-4.50","100,257.35","-","-","-","-","-","-","-","-","-","-","-","-","-","-","-","-","-","-","-","-","-","-","-","-","-"
"26 Nov 2024 19:12:11","Close Bet","O2-DC-9CWYXQ","T2-DC-5P4NTZ","O2-DC-9CWX4Z","Crude Oil West Texas - Cash","-","0.5","68.729","-","-","-","-","3,436.45","0.50","100,261.85","-","-","-","-","-","-","-","-","-","-","-","-","-","-","-","-","-","-","-","-","-","-","-","-","-"
"26 Nov 2024 19:09:55","Close Bet","O2-DC-9CWYQN","T2-DC-5P4NNY","O2-DC-9CWY1K","US 30 - Cash","-","20","44,714.33","-","-","-","-","894,286.60","581.60","100,261.35","-","-","-","-","-","-","-","-","-","-","-","-","-","-","-","-","-","-","-","-","-","-","-","-","-"
"26 Nov 2024 18:56:31","Stop Loss","O2-DC-9CWY19","T2-DC-5P4N2D","-","US 30 - Cash","-","20","44,749.56","-","-","-","-","894,991.20","-45.00","99,679.75","-","-","-","-","-","-","-","-","-","-","-","-","-","-","-","-","-","-","-","-","-","-","-","-","-"
"26 Nov 2024 18:55:54","Close Bet","O2-DC-9CWY0L","T2-DC-5P4N1X","O2-DC-9CWXZK","US 30 - Cash","-","20","44,756.47","-","-","-","-","895,129.40","-175.60","99,724.75","-","-","-","-","-","-","-","-","-","-","-","-","-","-","-","-","-","-","-","-","-","-","-","-","-"
"26 Nov 2024 18:53:32","Close Bet","O2-DC-9CWXYF","T2-DC-5P4N0D","O2-DC-9CWXTH","US 30 - Cash","-","20","44,752.20","-","-","-","-","895,044.00","-223.20","99,900.35","-","-","-","-","-","-","-","-","-","-","-","-","-","-","-","-","-","-","-","-","-","-","-","-","-"
"26 Nov 2024 18:49:10","Stop Loss","O2-DC-9CWXSF","T2-DC-5P4MWT","-","US 30 - Cash","-","18","44,742.16","-","-","-","-","805,358.88","-40.50","100,123.55","-","-","-","-","-","-","-","-","-","-","-","-","-","-","-","-","-","-","-","-","-","-","-","-","-"
"26 Nov 2024 18:49:10","Close Bet","O2-DC-9CWXSF","T2-DC-5P4MWR","O2-DC-9CWXNS","US 30 - Cash","-","2","44,744.41","-","-","-","-","89,488.82","-29.56","100,164.05","-","-","-","-","-","-","-","-","-","-","-","-","-","-","-","-","-","-","-","-","-","-","-","-","-"
"26 Nov 2024 18:41:40","Stop Loss","O2-DC-9CWX7C","T2-DC-5P4ML7","-","US 30 - Cash","-","2","44,727.34","-","-","-","-","89,454.68","-45.00","100,193.61","-","-","-","-","-","-","-","-","-","-","-","-","-","-","-","-","-","-","-","-","-","-","-","-","-"
"26 Nov 2024 18:35:29","Close Bet","O2-DC-9CWX3W","T2-DC-5P4MBM","O2-DC-9CWWV2","Crude Oil West Texas - Cash","-","0.5","68.564","-","-","-","-","3,428.20","-12.25","100,238.61","-","-","-","-","-","-","-","-","-","-","-","-","-","-","-","-","-","-","-","-","-","-","-","-","-"
"26 Nov 2024 18:35:29","Close Bet","O2-DC-9CWX3W","T2-DC-5P4MBL","O2-DC-9CWWKS","Crude Oil West Texas - Cash","-","0.5","68.564","-","-","-","-","3,428.20","-11.25","100,250.86","-","-","-","-","-","-","-","-","-","-","-","-","-","-","-","-","-","-","-","-","-","-","-","-","-"
"26 Nov 2024 18:20:55","Close Bet","O2-DC-9CWWKK","T2-DC-5P4LWD","O2-DC-9CWWEG","US NDAQ 100 - Cash","-","10","20,875.72","-","-","-","-","208,757.20","43.20","100,262.11","-","-","-","-","-","-","-","-","-","-","-","-","-","-","-","-","-","-","-","-","-","-","-","-","-"
"26 Nov 2024 18:20:38","Close Bet","O2-DC-9CWWK3","T2-DC-5P4LVT","O2-DC-9CWWDT","Crude Oil West Texas - Cash","-","1","68.764","-","-","-","-","6,876.40","26.60","100,218.91","-","-","-","-","-","-","-","-","-","-","-","-","-","-","-","-","-","-","-","-","-","-","-","-","-"
"26 Nov 2024 18:20:38","Close Bet","O2-DC-9CWWK3","T2-DC-5P4LVS","O2-DC-9CWWCV","Crude Oil West Texas - Cash","-","2","68.764","-","-","-","-","13,752.80","51.20","100,192.31","-","-","-","-","-","-","-","-","-","-","-","-","-","-","-","-","-","-","-","-","-","-","-","-","-"
"26 Nov 2024 18:20:38","Close Bet","O2-DC-9CWWK3","T2-DC-5P4LVR","O2-DC-9CWWCF","Crude Oil West Texas - Cash","-","2","68.764","-","-","-","-","13,752.80","59.20","100,141.11","-","-","-","-","-","-","-","-","-","-","-","-","-","-","-","-","-","-","-","-","-","-","-","-","-"
"26 Nov 2024 18:16:59","Close Bet","O2-DC-9CWWD5","T2-DC-5P4LPD","O2-DC-9CWW5H","US NDAQ 100 - Cash","-","1","20,891.90","-","-","-","-","20,891.90","-11.76","100,081.91","-","-","-","-","-","-","-","-","-","-","-","-","-","-","-","-","-","-","-","-","-","-","-","-","-"
"26 Nov 2024 18:14:21","Close Bet","O2-DC-9CWW82","T2-DC-5P4LKE","O2-DC-9CWW5Z","Crude Oil West Texas - Cash","-","2","68.303","-","-","-","-","13,660.60","-25.00","100,093.67","-","-","-","-","-","-","-","-","-","-","-","-","-","-","-","-","-","-","-","-","-","-","-","-","-"
"26 Nov 2024 18:14:21","Close Bet","O2-DC-9CWW82","T2-DC-5P4LKD","O2-DC-9CWVXD","Crude Oil West Texas - Cash","-","2","68.303","-","-","-","-","13,660.60","-17.00","100,118.67","-","-","-","-","-","-","-","-","-","-","-","-","-","-","-","-","-","-","-","-","-","-","-","-","-"
"26 Nov 2024 18:12:26","Take Profit","O2-DC-9CWVZ5","T2-DC-5P4LG3","-","US NDAQ 100 - Cash","-","7","20,881.05","-","-","-","-","146,167.35","64.96","100,135.67","-","-","-","-","-","-","-","-","-","-","-","-","-","-","-","-","-","-","-","-","-","-","-","-","-"
"26 Nov 2024 18:11:55","Close Bet","O2-DC-9CWW39","T2-DC-5P4LF5","O2-DC-9CWVZ0","Crude Oil West Texas - Jan 2025","-","7","68.143","-","-","-","-","47,700.10","10.50","100,070.71","-","-","-","-","-","-","-","-","-","-","-","-","-","-","-","-","-","-","-","-","-","-","-","-","-"
"26 Nov 2024 18:11:55","Close Bet","O2-DC-9CWW39","T2-DC-5P4LF4","O2-DC-9CWVVG","Crude Oil West Texas - Jan 2025","-","2","68.143","-","-","-","-","13,628.60","-5.00","100,060.21","-","-","-","-","-","-","-","-","-","-","-","-","-","-","-","-","-","-","-","-","-","-","-","-","-"
"26 Nov 2024 18:11:30","Close Bet","O2-DC-9CWW2M","T2-DC-5P4LEP","O2-DC-9CWVM0","Crude Oil West Texas - Cash","-","2","68.283","-","-","-","-","13,656.60","-61.20","100,065.21","-","-","-","-","-","-","-","-","-","-","-","-","-","-","-","-","-","-","-","-","-","-","-","-","-"
"26 Nov 2024 18:08:48","Stop Loss","O2-DC-9CWVWH","T2-DC-5P4LB8","-","US NDAQ 100 - Cash","-","2","20,896.59","-","-","-","-","41,793.18","-12.08","100,126.41","-","-","-","-","-","-","-","-","-","-","-","-","-","-","-","-","-","-","-","-","-","-","-","-","-"
"26 Nov 2024 18:08:44","Close Bet","O2-DC-9CWVYH","T2-DC-5P4LB6","O2-DC-9CWVWH","US NDAQ 100 - Cash","-","7","20,899.79","-","-","-","-","146,298.53","-19.88","100,138.49","-","-","-","-","-","-","-","-","-","-","-","-","-","-","-","-","-","-","-","-","-","-","-","-","-"
"26 Nov 2024 18:07:29","Close Bet","O2-DC-9CWVWH","T2-DC-5P4L8L","O2-DC-9CWVV1","US NDAQ 100 - Cash","-","1","20,902.63","-","-","-","-","20,902.63","-8.96","100,158.37","-","-","-","-","-","-","-","-","-","-","-","-","-","-","-","-","-","-","-","-","-","-","-","-","-"
"26 Nov 2024 18:05:19","Close Bet","O2-DC-9CWVS0","T2-DC-5P4L59","O2-DC-9CWVQP","Crude Oil West Texas - Jan 2025","-","2","68.103","-","-","-","-","13,620.60","9.00","100,167.33","-","-","-","-","-","-","-","-","-","-","-","-","-","-","-","-","-","-","-","-","-","-","-","-","-"
"26 Nov 2024 18:04:35","Close Bet","O2-DC-9CWVQY","T2-DC-5P4L45","O2-DC-9CVCEG","Gold - Cash","-","1","2,622.43","-","-","-","-","2,622.43","7.43","100,158.33","-","-","-","-","-","-","-","-","-","-","-","-","-","-","-","-","-","-","-","-","-","-","-","-","-"
"26 Nov 2024 18:04:35","Close Bet","O2-DC-9CWVQY","T2-DC-5P4L44","O2-DC-9CVC7H","Gold - Cash","-","1","2,622.43","-","-","-","-","2,622.43","-7.85","100,150.90","-","-","-","-","-","-","-","-","-","-","-","-","-","-","-","-","-","-","-","-","-","-","-","-","-"
"26 Nov 2024 18:02:50","Close Bet","O2-DC-9CWVNN","T2-DC-5P4L26","O2-DC-9CWV61","US NDAQ 100 - Cash","-","1","20,896.92","-","-","-","-","20,896.92","-1.30","100,158.75","-","-","-","-","-","-","-","-","-","-","-","-","-","-","-","-","-","-","-","-","-","-","-","-","-"
"26 Nov 2024 17:56:16","Close Bet","O2-DC-9CWVDT","T2-DC-5P4KSM","O2-DC-9CWV9G","Crude Oil West Texas - Cash","-","2","68.544","-","-","-","-","13,708.80","-13.00","100,160.05","-","-","-","-","-","-","-","-","-","-","-","-","-","-","-","-","-","-","-","-","-","-","-","-","-"
"26 Nov 2024 17:48:34","Close Bet","O2-DC-9CWV30","T2-DC-5P4KKC","O2-DC-9CWV03","Crude Oil West Texas - Cash","-","0.5","68.604","-","-","-","-","3,430.20","-5.25","100,173.05","-","-","-","-","-","-","-","-","-","-","-","-","-","-","-","-","-","-","-","-","-","-","-","-","-"
"26 Nov 2024 17:44:15","Close Bet","O2-DC-9CWTX8","T2-DC-5P4KE1","O2-DC-9CWTQM","US NDAQ 100 - Cash","-","1","20,894.12","-","-","-","-","20,894.12","7.50","100,178.30","-","-","-","-","-","-","-","-","-","-","-","-","-","-","-","-","-","-","-","-","-","-","-","-","-"
"26 Nov 2024 17:43:58","Close Bet","O2-DC-9CWTWN","T2-DC-5P4KDM","O2-DC-9CWTTF","Crude Oil West Texas - Cash","-","2","68.649","-","-","-","-","13,729.80","9.00","100,170.80","-","-","-","-","-","-","-","-","-","-","-","-","-","-","-","-","-","-","-","-","-","-","-","-","-"
"26 Nov 2024 17:43:02","Close Bet","O2-DC-9CWTT6","T2-DC-5P4KBW","O2-DC-9CWTRC","Crude Oil West Texas - Cash","-","2","68.714","-","-","-","-","13,742.80","-3.00","100,161.80","-","-","-","-","-","-","-","-","-","-","-","-","-","-","-","-","-","-","-","-","-","-","-","-","-"
"26 Nov 2024 17:40:57","Close Bet","O2-DC-9CWTP8","T2-DC-5P4K7K","O2-DC-9CWTN2","US NDAQ 100 - Cash","-","1","20,884.12","-","-","-","-","20,884.12","0.91","100,164.80","-","-","-","-","-","-","-","-","-","-","-","-","-","-","-","-","-","-","-","-","-","-","-","-","-"
"26 Nov 2024 17:40:57","Close Bet","O2-DC-9CWTP8","T2-DC-5P4K7J","O2-DC-9CWTMG","US NDAQ 100 - Cash","-","1","20,884.12","-","-","-","-","20,884.12","2.15","100,163.89","-","-","-","-","-","-","-","-","-","-","-","-","-","-","-","-","-","-","-","-","-","-","-","-","-"
"26 Nov 2024 17:40:57","Close Bet","O2-DC-9CWTP8","T2-DC-5P4K7H","O2-DC-9CWTM3","US NDAQ 100 - Cash","-","1","20,884.12","-","-","-","-","20,884.12","1.40","100,161.74","-","-","-","-","-","-","-","-","-","-","-","-","-","-","-","-","-","-","-","-","-","-","-","-","-"
"26 Nov 2024 17:39:21","Close Bet","O2-DC-9CWTLT","T2-DC-5P4K5W","O2-DC-9CWRV8","US NDAQ 100 - Cash","-","1","20,878.10","-","-","-","-","20,878.10","-8.70","100,160.34","-","-","-","-","-","-","-","-","-","-","-","-","-","-","-","-","-","-","-","-","-","-","-","-","-"
"26 Nov 2024 17:28:30","Close Bet","O2-DC-9CWT58","T2-DC-5P4JVB","O2-DC-9CWT0W","Crude Oil West Texas - Cash","-","2","68.850","-","-","-","-","13,770.00","0.20","100,169.04","-","-","-","-","-","-","-","-","-","-","-","-","-","-","-","-","-","-","-","-","-","-","-","-","-"
"26 Nov 2024 17:27:36","Close Bet","O2-DC-9CWT3M","T2-DC-5P4JSV","O2-DC-9CWSTL","US NDAQ 100 - Dec 2024","-","2","20,937.88","-","-","-","-","41,875.76","-20.50","100,168.84","-","-","-","-","-","-","-","-","-","-","-","-","-","-","-","-","-","-","-","-","-","-","-","-","-"
"26 Nov 2024 17:24:07","Close Bet","O2-DC-9CWSYK","T2-DC-5P4JP8","O2-DC-9CWSTD","US NDAQ 100 - Dec 2024","-","1","20,936.75","-","-","-","-","20,936.75","-7.00","100,189.34","-","-","-","-","-","-","-","-","-","-","-","-","-","-","-","-","-","-","-","-","-","-","-","-","-"
"26 Nov 2024 17:19:37","Close Bet","O2-DC-9CWSQ8","T2-DC-5P4JH6","O2-DC-9CWRWW","US NDAQ 100 - Cash","-","1","20,854.26","-","-","-","-","20,854.26","-34.60","100,196.34","-","-","-","-","-","-","-","-","-","-","-","-","-","-","-","-","-","-","-","-","-","-","-","-","-"
"26 Nov 2024 16:58:39","Close Bet","O2-DC-9CWRND","T2-DC-5P4HML","O2-DC-9CWLEK","Crude Oil West Texas - Cash","-","0.2","69.426","-","-","-","-","1,388.52","-12.14","100,230.94","-","-","-","-","-","-","-","-","-","-","-","-","-","-","-","-","-","-","-","-","-","-","-","-","-"
"26 Nov 2024 16:06:13","Close Bet","O2-DC-9CWNH3","T2-DC-5P4F1K","O2-DC-9CWKLM","Crude Oil West Texas - Cash","-","0.5","69.737","-","-","-","-","3,486.85","-8.30","100,243.08","-","-","-","-","-","-","-","-","-","-","-","-","-","-","-","-","-","-","-","-","-","-","-","-","-"
"26 Nov 2024 16:06:00","Close Bet","O2-DC-9CWNGD","T2-DC-5P4F0Z","O2-DC-9CWMT6","US 30 - Cash","-","0.3","44,513.05","-","-","-","-","13,353.91","-1.53","100,251.38","-","-","-","-","-","-","-","-","-","-","-","-","-","-","-","-","-","-","-","-","-","-","-","-","-"
"26 Nov 2024 15:59:49","Close Bet","O2-DC-9CWMQT","T2-DC-5P4EGL","O2-DC-9CWL8S","US 30 - Cash","-","0.3","44,499.47","-","-","-","-","13,349.84","2.78","100,252.91","-","-","-","-","-","-","-","-","-","-","-","-","-","-","-","-","-","-","-","-","-","-","-","-","-"
"26 Nov 2024 15:41:13","Close Bet","O2-DC-9CWL1H","T2-DC-5P4CWE","O2-DC-9CWJ5M","US 30 - Cash","-","0.3","44,442.01","-","-","-","-","13,332.60","12.07","100,250.13","-","-","-","-","-","-","-","-","-","-","-","-","-","-","-","-","-","-","-","-","-","-","-","-","-"
"26 Nov 2024 15:22:25","Close Bet","O2-DC-9CWJ1R","T2-DC-5P4B7T","O2-DC-9CWHDX","US 30 - Cash","-","0.3","44,509.08","-","-","-","-","13,352.72","-8.00","100,238.06","-","-","-","-","-","-","-","-","-","-","-","-","-","-","-","-","-","-","-","-","-","-","-","-","-"
"26 Nov 2024 15:22:25","Close Bet","O2-DC-9CWJ1R","T2-DC-5P4B7S","O2-DC-9CWGEG","US 30 - Cash","-","0.3","44,509.08","-","-","-","-","13,352.72","-12.17","100,246.06","-","-","-","-","-","-","-","-","-","-","-","-","-","-","-","-","-","-","-","-","-","-","-","-","-"
"26 Nov 2024 15:16:41","Close Bet","O2-DC-9CWHCM","T2-DC-5P49MN","O2-DC-9CWDT3","Crude Oil West Texas - Cash","-","0.5","69.557","-","-","-","-","3,477.85","-26.80","100,258.23","-","-","-","-","-","-","-","-","-","-","-","-","-","-","-","-","-","-","-","-","-","-","-","-","-"
"26 Nov 2024 15:16:41","Close Bet","O2-DC-9CWHCM","T2-DC-5P49MM","O2-DC-9CWDF5","Crude Oil West Texas - Cash","-","0.5","69.557","-","-","-","-","3,477.85","-37.85","100,285.03","-","-","-","-","-","-","-","-","-","-","-","-","-","-","-","-","-","-","-","-","-","-","-","-","-"
"26 Nov 2024 15:06:41","Close Bet","O2-DC-9CWG7Z","T2-DC-5P48SM","O2-DC-9CWFL5","US 30 - Cash","-","1","44,478.57","-","-","-","-","44,478.57","48.93","100,322.88","-","-","-","-","-","-","-","-","-","-","-","-","-","-","-","-","-","-","-","-","-","-","-","-","-"
"26 Nov 2024 15:06:34","Close Bet","O2-DC-9CWG7L","T2-DC-5P48S7","O2-DC-9CWFGV","US 30 - Cash","-","1","44,475.50","-","-","-","-","44,475.50","56.51","100,273.95","-","-","-","-","-","-","-","-","-","-","-","-","-","-","-","-","-","-","-","-","-","-","-","-","-"
"26 Nov 2024 14:49:59","Close Bet","O2-DC-9CWE13","T2-DC-5P46X3","O2-DC-9CWCPC","US 30 - Cash","-","1","44,539.52","-","-","-","-","44,539.52","-1.99","100,217.44","-","-","-","-","-","-","-","-","-","-","-","-","-","-","-","-","-","-","-","-","-","-","-","-","-"
"26 Nov 2024 14:44:38","Close Bet","O2-DC-9CWDDC","T2-DC-5P468G","O2-DC-9CWD8K","Crude Oil West Texas - Cash","-","2","70.369","-","-","-","-","14,073.80","65.20","100,219.43","-","-","-","-","-","-","-","-","-","-","-","-","-","-","-","-","-","-","-","-","-","-","-","-","-"
"26 Nov 2024 05:30:52","Stop Loss","O2-DC-9CVCFM","T2-DC-5P3GWX","-","Gold - Cash","-","4","2,620.03","-","-","-","-","10,480.12","-40.96","100,154.23","-","-","-","-","-","-","-","-","-","-","-","-","-","-","-","-","-","-","-","-","-","-","-","-","-"
"26 Nov 2024 03:09:52","Stop Loss","O2-DC-9CVCSV","T2-DC-5P3EH3","-","US 30 - Cash","-","1","44,708.29","-","-","-","-","44,708.29","-57.40","100,195.19","-","-","-","-","-","-","-","-","-","-","-","-","-","-","-","-","-","-","-","-","-","-","-","-","-"
"26 Nov 2024 02:35:01","Stop Loss","O2-DC-9CVE13","T2-DC-5P3DWT","-","US 30 - Cash","-","5","44,681.90","-","-","-","-","223,409.50","-44.05","100,252.59","-","-","-","-","-","-","-","-","-","-","-","-","-","-","-","-","-","-","-","-","-","-","-","-","-"
"26 Nov 2024 02:30:25","Close Bet","O2-DC-9CVE0N","T2-DC-5P3DV0","O2-DC-9CVDXT","US 30 - Cash","-","5","44,681.90","-","-","-","-","223,409.50","5.30","100,296.64","-","-","-","-","-","-","-","-","-","-","-","-","-","-","-","-","-","-","-","-","-","-","-","-","-"
"26 Nov 2024 02:18:12","Close Bet","O2-DC-9CVDMP","T2-DC-5P3DKP","O2-DC-9CVDLZ","US 30 - Cash","-","5","44,684.30","-","-","-","-","223,421.50","-42.10","100,291.34","-","-","-","-","-","-","-","-","-","-","-","-","-","-","-","-","-","-","-","-","-","-","-","-","-"
"26 Nov 2024 02:16:26","Close Bet","O2-DC-9CVDL7","T2-DC-5P3DJP","O2-DC-9CVDKK","US 30 - Cash","-","5","44,683.26","-","-","-","-","223,416.30","-41.95","100,333.44","-","-","-","-","-","-","-","-","-","-","-","-","-","-","-","-","-","-","-","-","-","-","-","-","-"
"26 Nov 2024 02:14:21","Close Bet","O2-DC-9CVDJ2","T2-DC-5P3DHD","O2-DC-9CVDDB","US 30 - Cash","-","1","44,684.25","-","-","-","-","44,684.25","-4.46","100,375.39","-","-","-","-","-","-","-","-","-","-","-","-","-","-","-","-","-","-","-","-","-","-","-","-","-"
"26 Nov 2024 01:51:21","Close Bet","O2-DC-9CVCPW","T2-DC-5P3CTK","O2-DC-9CVCJH","US 30 - Cash","-","1","44,659.26","-","-","-","-","44,659.26","-20.86","100,379.85","-","-","-","-","-","-","-","-","-","-","-","-","-","-","-","-","-","-","-","-","-","-","-","-","-"
"26 Nov 2024 01:00:11","Close Bet","O2-DC-9CV8Z5","T2-DC-5P39BK","O2-DC-9CV89H","GBP/JPY","-","3","192.755","-","-","-","-","57,826.50","31.20","100,400.71","-","-","-","-","-","-","-","-","-","-","-","-","-","-","-","-","-","-","-","-","-","-","-","-","-"
"26 Nov 2024 00:40:45","Close Bet","O2-DC-9CV88K","T2-DC-5P38QK","O2-DC-9CV846","GBP/JPY","-","9","192.904","-","-","-","-","173,613.60","48.60","100,369.51","-","-","-","-","-","-","-","-","-","-","-","-","-","-","-","-","-","-","-","-","-","-","-","-","-"
"26 Nov 2024 00:40:45","Close Bet","O2-DC-9CV88K","T2-DC-5P38QJ","O2-DC-9CV82T","GBP/JPY","-","1","192.904","-","-","-","-","19,290.40","4.50","100,320.91","-","-","-","-","-","-","-","-","-","-","-","-","-","-","-","-","-","-","-","-","-","-","-","-","-"
"26 Nov 2024 00:33:45","Close Bet","O2-DC-9CV800","T2-DC-5P38G0","O2-DC-9CV7LN","Gold - Cash","-","2.5","2,622.87","-","-","-","-","6,557.17","3.95","100,316.41","-","-","-","-","-","-","-","-","-","-","-","-","-","-","-","-","-","-","-","-","-","-","-","-","-"
"26 Nov 2024 00:33:37","Close Bet","O2-DC-9CV7ZT","T2-DC-5P38FV","O2-DC-9CV7QJ","GBP/JPY","-","0.5","193.060","-","-","-","-","9,653.00","10.50","100,312.46","-","-","-","-","-","-","-","-","-","-","-","-","-","-","-","-","-","-","-","-","-","-","-","-","-"
"26 Nov 2024 00:33:37","Close Bet","O2-DC-9CV7ZT","T2-DC-5P38FT","O2-DC-9CV6VP","GBP/JPY","-","1.5","193.060","-","-","-","-","28,959.00","5.85","100,301.96","-","-","-","-","-","-","-","-","-","-","-","-","-","-","-","-","-","-","-","-","-","-","-","-","-"
"26 Nov 2024 00:33:01","Close Bet","O2-DC-9CV7Z2","T2-DC-5P38F3","O2-DC-9CV7W3","USD/CHF","-","5","0.88764","-","-","-","-","44,382.00","17.00","100,296.11","-","-","-","-","-","-","-","-","-","-","-","-","-","-","-","-","-","-","-","-","-","-","-","-","-"
"26 Nov 2024 00:33:01","Close Bet","O2-DC-9CV7Z2","T2-DC-5P38F2","O2-DC-9CV7V2","USD/CHF","-","2","0.88764","-","-","-","-","17,752.80","6.40","100,279.11","-","-","-","-","-","-","-","-","-","-","-","-","-","-","-","-","-","-","-","-","-","-","-","-","-"
"26 Nov 2024 00:32:02","Close Bet","O2-DC-9CV7XL","T2-DC-5P38DW","O2-DC-9CV7HJ","GBP/JPY","-","1.5","193.071","-","-","-","-","28,960.65","12.45","100,272.71","-","-","-","-","-","-","-","-","-","-","-","-","-","-","-","-","-","-","-","-","-","-","-","-","-"
"26 Nov 2024 00:25:19","Close Bet","O2-DC-9CV7NZ","T2-DC-5P387L","O2-DC-9CV7LN","Gold - Cash","-","2.5","2,622.57","-","-","-","-","6,556.42","3.20","100,260.26","-","-","-","-","-","-","-","-","-","-","-","-","-","-","-","-","-","-","-","-","-","-","-","-","-"
"26 Nov 2024 00:19:19","Close Bet","O2-DC-9CV778","T2-DC-5P37TG","O2-DC-9CV70K","Japan 225 - Cash","-","2","38,348.50","-","-","-","-","76,697.00","86.00","100,257.06","-","-","-","-","-","-","-","-","-","-","-","-","-","-","-","-","-","-","-","-","-","-","-","-","-"
"26 Nov 2024 00:18:23","Close Bet","O2-DC-9CV74V","T2-DC-5P37RR","O2-DC-9CV6EE","US 30 - Cash","-","1","44,589.00","-","-","-","-","44,589.00","13.29","100,171.06","-","-","-","-","-","-","-","-","-","-","-","-","-","-","-","-","-","-","-","-","-","-","-","-","-"
"26 Nov 2024 00:15:57","Close Bet","O2-DC-9CV6ZR","T2-DC-5P37MM","O2-DC-9CV6EE","US 30 - Cash","-","0.5","44,575.04","-","-","-","-","22,287.52","13.63","100,157.77","-","-","-","-","-","-","-","-","-","-","-","-","-","-","-","-","-","-","-","-","-","-","-","-","-"
"26 Nov 2024 00:06:06","Close Bet","O2-DC-9CV6DB","T2-DC-5P36ZV","O2-DC-9CV5KW","US 30 - Cash","-","0.5","44,605.69","-","-","-","-","22,302.84","5.49","100,144.14","-","-","-","-","-","-","-","-","-","-","-","-","-","-","-","-","-","-","-","-","-","-","-","-","-"
"26 Nov 2024 00:05:43","Close Bet","O2-DC-9CV6CK","T2-DC-5P36ZG","O2-DB-9CPC4M","Japan 225 - Cash","-","0.3","38,376.50","-","-","-","-","11,512.95","32.40","100,138.65","-","-","-","-","-","-","-","-","-","-","-","-","-","-","-","-","-","-","-","-","-","-","-","-","-"
"25 Nov 2024 13:05:08","Close Bet","O2-DC-9CSVZM","T2-DC-5P20S4","O2-DC-9CSV3S","US 30 - Cash","-","0.3","44,600.70","-","-","-","-","13,380.21","8.90","100,107.28","-","-","-","-","-","-","-","-","-","-","-","-","-","-","-","-","-","-","-","-","-","-","-","-","-"
"25 Nov 2024 12:50:42","Close Bet","O2-DC-9CSVEM","T2-DC-5P208M","O2-DC-9CRXV8","GBP/JPY","-","0.5","193.771","-","-","-","-","9,688.55","-22.60","100,098.38","-","-","-","-","-","-","-","-","-","-","-","-","-","-","-","-","-","-","-","-","-","-","-","-","-"
"25 Nov 2024 11:26:17","Close Bet","O2-DC-9CSR51","T2-DC-5P1XMW","O2-DB-9CPC1F","Crude Oil West Texas - Jan 2025","-","0.5","70.988","-","-","-","-","3,549.40","73.90","100,120.98","-","-","-","-","-","-","-","-","-","-","-","-","-","-","-","-","-","-","-","-","-","-","-","-","-"
"25 Nov 2024 11:22:19","Close Bet","O2-DC-9CSR0W","T2-DC-5P1XJH","O2-DC-9CS0XD","Japan 225 - Dec 2024","-","0.3","38,707.5","-","-","-","-","11,612.25","-0.75","100,047.08","-","-","-","-","-","-","-","-","-","-","-","-","-","-","-","-","-","-","-","-","-","-","-","-","-"
"25 Nov 2024 11:20:51","Close Bet","O2-DC-9CSQZ4","T2-DC-5P1XH0","O2-DC-9CSMHY","Crude Oil West Texas - Cash","-","0.5","71.233","-","-","-","-","3,561.65","-24.30","100,047.83","-","-","-","-","-","-","-","-","-","-","-","-","-","-","-","-","-","-","-","-","-","-","-","-","-"
"25 Nov 2024 11:18:53","Close Bet","O2-DC-9CSQWZ","T2-DC-5P1XFN","O2-DB-9CKEHY","EU Natural Gas (TTF) - Jan 2025","-","0.5","48.02","-","-","-","-","2,401.00","24.00","100,072.13","-","-","-","-","-","-","-","-","-","-","-","-","-","-","-","-","-","-","-","-","-","-","-","-","-"
"25 Nov 2024 11:15:28","Close Bet","O2-DC-9CSQQE","T2-DC-5P1XBS","O2-DC-9CSQP8","US 30 - Cash","-","0.3","44,588.68","-","-","-","-","13,376.60","-2.80","100,048.13","-","-","-","-","-","-","-","-","-","-","-","-","-","-","-","-","-","-","-","-","-","-","-","-","-"
"25 Nov 2024 11:11:36","Close Bet","O2-DC-9CSQJY","T2-DC-5P1X5K","O2-DC-9CSMY8","Gold - Cash","-","2","2,682.59","-","-","-","-","5,365.18","-1.18","100,050.93","-","-","-","-","-","-","-","-","-","-","-","-","-","-","-","-","-","-","-","-","-","-","-","-","-"
"25 Nov 2024 02:21:01","Close Bet","O2-DC-9CS51B","T2-DC-5P1FGW","O2-DC-9CS4SV","Japan 225 - Dec 2024","-","0.5","38,812.5","-","-","-","-","19,406.25","8.75","100,052.11","-","-","-","-","-","-","-","-","-","-","-","-","-","-","-","-","-","-","-","-","-","-","-","-","-"
"25 Nov 2024 01:55:47","Close Bet","O2-DC-9CS4CZ","T2-DC-5P1EY0","O2-DC-9CS3Z9","Japan 225 - Dec 2024","-","0.1","38,870.0","-","-","-","-","3,887.00","5.00","100,043.36","-","-","-","-","-","-","-","-","-","-","-","-","-","-","-","-","-","-","-","-","-","-","-","-","-"
"25 Nov 2024 01:53:13","Close Bet","O2-DC-9CS498","T2-DC-5P1EVD","O2-DC-9CS47X","Japan 225 - Dec 2024","-","0.5","38,890.0","-","-","-","-","19,445.00","17.50","100,038.36","-","-","-","-","-","-","-","-","-","-","-","-","-","-","-","-","-","-","-","-","-","-","-","-","-"
"25 Nov 2024 01:51:03","Close Bet","O2-DC-9CS47B","T2-DC-5P1ESQ","O2-DC-9CS3ZK","Japan 225 - Cash","-","0.1","38,921.50","-","-","-","-","3,892.15","0.30","100,020.86","-","-","-","-","-","-","-","-","-","-","-","-","-","-","-","-","-","-","-","-","-","-","-","-","-"
"25 Nov 2024 01:38:06","Close Bet","O2-DC-9CS3V2","T2-DC-5P1EGB","O2-DC-9CS3D1","Japan 225 - Dec 2024","-","0.2","38,920.0","-","-","-","-","7,784.00","6.00","100,020.56","-","-","-","-","-","-","-","-","-","-","-","-","-","-","-","-","-","-","-","-","-","-","-","-","-"
"25 Nov 2024 01:29:09","Close Bet","O2-DC-9CS3EF","T2-DC-5P1E31","O2-DC-9CS3DM","Japan 225 - Cash","-","0.3","38,966.50","-","-","-","-","11,689.95","-0.60","100,014.56","-","-","-","-","-","-","-","-","-","-","-","-","-","-","-","-","-","-","-","-","-","-","-","-","-"
"25 Nov 2024 01:22:26","Close Bet","O2-DC-9CS366","T2-DC-5P1DXC","O2-DC-9CS2J1","Japan 225 - Dec 2024","-","0.5","38,980.0","-","-","-","-","19,490.00","16.25","100,015.16","-","-","-","-","-","-","-","-","-","-","-","-","-","-","-","-","-","-","-","-","-","-","-","-","-"
"25 Nov 2024 01:18:12","Close Bet","O2-DC-9CS326","T2-DC-5P1DSC","O2-DC-9CS2X4","Japan 225 - Cash","-","0.5","39,006.50","-","-","-","-","19,503.25","-21.00","99,998.91","-","-","-","-","-","-","-","-","-","-","-","-","-","-","-","-","-","-","-","-","-","-","-","-","-"
"25 Nov 2024 01:17:21","Close Bet","O2-DC-9CS314","T2-DC-5P1DR8","O2-DC-9CS2XG","Japan 225 - Dec 2024","-","0.5","39,045.0","-","-","-","-","19,522.50","-10.00","100,019.91","-","-","-","-","-","-","-","-","-","-","-","-","-","-","-","-","-","-","-","-","-","-","-","-","-"
"25 Nov 2024 01:12:45","Close Bet","O2-DC-9CS2WM","T2-DC-5P1DLK","O2-DC-9CS2VV","Japan 225 - Cash","-","0.5","39,036.50","-","-","-","-","19,518.25","4.00","100,029.91","-","-","-","-","-","-","-","-","-","-","-","-","-","-","-","-","-","-","-","-","-","-","-","-","-"
"25 Nov 2024 01:08:22","Close Bet","O2-DC-9CS2PT","T2-DC-5P1DG3","O2-DC-9CS2NB","Japan 225 - Cash","-","0.5","39,054.00","-","-","-","-","19,527.00","7.75","100,025.91","-","-","-","-","-","-","-","-","-","-","-","-","-","-","-","-","-","-","-","-","-","-","-","-","-"
"25 Nov 2024 01:00:03","Close Bet","O2-DC-9CS2C7","T2-DC-5P1D3W","O2-DC-9CS29Q","Japan 225 - Dec 2024","-","0.1","39,052.5","-","-","-","-","3,905.25","-2.00","100,018.16","-","-","-","-","-","-","-","-","-","-","-","-","-","-","-","-","-","-","-","-","-","-","-","-","-"
"25 Nov 2024 00:54:25","Close Bet","O2-DC-9CS27E","T2-DC-5P1D03","O2-DC-9CS26F","Japan 225 - Dec 2024","-","0.1","39,045.0","-","-","-","-","3,904.50","-1.25","100,020.16","-","-","-","-","-","-","-","-","-","-","-","-","-","-","-","-","-","-","-","-","-","-","-","-","-"
"25 Nov 2024 00:48:48","Close Bet","O2-DC-9CS229","T2-DC-5P1CVM","O2-DC-9CS0WS","Crude Oil West Texas - Cash","-","0.5","71.489","-","-","-","-","3,574.45","0.50","100,021.41","-","-","-","-","-","-","-","-","-","-","-","-","-","-","-","-","-","-","-","-","-","-","-","-","-"
"25 Nov 2024 00:42:57","Close Bet","O2-DC-9CS1Y3","T2-DC-5P1CQM","O2-DC-9CS1XG","Japan 225 - Cash","-","0.2","38,951.50","-","-","-","-","7,790.30","2.10","100,020.91","-","-","-","-","-","-","-","-","-","-","-","-","-","-","-","-","-","-","-","-","-","-","-","-","-"
"25 Nov 2024 00:36:52","Close Bet","O2-DC-9CS1SW","T2-DC-5P1CLY","O2-DC-9CS0XD","Japan 225 - Dec 2024","-","0.1","38,880.0","-","-","-","-","3,888.00","-17.50","100,018.81","-","-","-","-","-","-","-","-","-","-","-","-","-","-","-","-","-","-","-","-","-","-","-","-","-"
"25 Nov 2024 00:31:43","Close Bet","O2-DC-9CS1MS","T2-DC-5P1CH7","O2-DC-9CS1HK","Japan 225 - Cash","-","0.2","38,926.50","-","-","-","-","7,785.30","6.60","100,036.31","-","-","-","-","-","-","-","-","-","-","-","-","-","-","-","-","-","-","-","-","-","-","-","-","-"
"25 Nov 2024 00:26:53","Close Bet","O2-DC-9CS1FW","T2-DC-5P1CC3","O2-DC-9CS1BB","Japan 225 - Cash","-","0.2","38,854.00","-","-","-","-","7,770.80","9.10","100,029.71","-","-","-","-","-","-","-","-","-","-","-","-","-","-","-","-","-","-","-","-","-","-","-","-","-"
"25 Nov 2024 00:23:23","Close Bet","O2-DC-9CS1B4","T2-DC-5P1C75","O2-DC-9CS0XD","Japan 225 - Dec 2024","-","0.1","38,827.5","-","-","-","-","3,882.75","-12.25","100,020.61","-","-","-","-","-","-","-","-","-","-","-","-","-","-","-","-","-","-","-","-","-","-","-","-","-"
"25 Nov 2024 00:21:58","Close Bet","O2-DC-9CS18P","T2-DC-5P1C5W","O2-DC-9CS10F","Japan 225 - Cash","-","0.2","38,764.00","-","-","-","-","7,752.80","1.10","100,032.86","-","-","-","-","-","-","-","-","-","-","-","-","-","-","-","-","-","-","-","-","-","-","-","-","-"
"25 Nov 2024 00:13:44","Close Bet","O2-DC-9CS0WH","T2-DC-5P1BSK","O2-DB-9CPC0Z","Crude Oil West Texas - Cash","-","0.5","71.509","-","-","-","-","3,575.45","52.30","100,031.76","-","-","-","-","-","-","-","-","-","-","-","-","-","-","-","-","-","-","-","-","-","-","-","-","-"
"24 Nov 2024 23:03:32","Close Bet","O2-DC-9CRX3R","T2-DC-5P17GD","O2-DB-9CPC5E","Gold - Cash","-","0.5","2,706.32","-","-","-","-","1,353.16","16.93","99,979.46","-","-","-","-","-","-","-","-","-","-","-","-","-","-","-","-","-","-","-","-","-","-","-","-","-"
"24 Nov 2024 23:02:21","Close Bet","O2-DC-9CRX08","T2-DC-5P17DZ","O2-DB-9CPBR6","USD/CAD","-","3","1.39455","-","-","-","-","41,836.50","-96.60","99,962.53","-","-","-","-","-","-","-","-","-","-","-","-","-","-","-","-","-","-","-","-","-","-","-","-","-"
"22 Nov 2024 09:36:59","Close Bet","O2-DB-9CQ1H2","T2-DB-5NZMLH","O2-DB-9CPE0B","GBP/JPY","-","0.5","193.411","-","-","-","-","9,670.55","-49.65","100,061.94","-","-","-","-","-","-","-","-","-","-","-","-","-","-","-","-","-","-","-","-","-","-","-","-","-"
"22 Nov 2024 01:22:03","Close Bet","O2-DB-9CPDK4","T2-DB-5NZ1NZ","O2-DB-9CK3CH","Germany 40 - Cash","-","0.1","19,195.04","-","-","-","-","1,919.50","7.22","100,111.59","-","-","-","-","-","-","-","-","-","-","-","-","-","-","-","-","-","-","-","-","-","-","-","-","-"
"22 Nov 2024 01:18:30","Close Bet","O2-DB-9CPDG4","T2-DB-5NZ1LY","O2-DB-9CPCXQ","Japan 225 - Cash","-","1","38,319.00","-","-","-","-","38,319.00","5.50","100,104.37","-","-","-","-","-","-","-","-","-","-","-","-","-","-","-","-","-","-","-","-","-","-","-","-","-"
"21 Nov 2024 14:40:11","Stop Loss","O2-DB-9CJBXW","T2-DB-5NY0RG","-","GBP/USD","-","0.1","1.26201","-","-","-","-","1,262.01","-6.98","100,099.19","-","-","-","-","-","-","-","-","-","-","-","-","-","-","-","-","-","-","-","-","-","-","-","-","-"
"21 Nov 2024 09:08:34","Stop Loss","O2-DB-9CL2L0","T2-DB-5NXDRB","-","GBP/USD","-","0.2","1.26301","-","-","-","-","2,526.02","-2.50","100,106.17","-","-","-","-","-","-","-","-","-","-","-","-","-","-","-","-","-","-","-","-","-","-","-","-","-"
"21 Nov 2024 07:41:41","Close Bet","O2-DB-9CM2WR","T2-DB-5NX74L","O2-DB-9CLCRR","Crude Oil West Texas - Cash","-","1","69.619","-","-","-","-","6,961.90","34.50","100,108.67","-","-","-","-","-","-","-","-","-","-","-","-","-","-","-","-","-","-","-","-","-","-","-","-","-"
"21 Nov 2024 07:41:41","Close Bet","O2-DB-9CM2WR","T2-DB-5NX74K","O2-DB-9CLBVW","Crude Oil West Texas - Cash","-","0.5","69.619","-","-","-","-","3,480.95","18.75","100,074.17","-","-","-","-","-","-","-","-","-","-","-","-","-","-","-","-","-","-","-","-","-","-","-","-","-"
"21 Nov 2024 07:41:41","Close Bet","O2-DB-9CM2WR","T2-DB-5NX74J","O2-DB-9CL280","Crude Oil West Texas - Cash","-","0.5","69.619","-","-","-","-","3,480.95","-0.85","100,055.42","-","-","-","-","-","-","-","-","-","-","-","-","-","-","-","-","-","-","-","-","-","-","-","-","-"
"21 Nov 2024 07:39:30","Close Bet","O2-DB-9CM2SV","T2-DB-5NX72M","O2-DB-9CLGNJ","US NDAQ 100 - Cash","-","1","20,555.63","-","-","-","-","20,555.63","-140.39","100,056.27","-","-","-","-","-","-","-","-","-","-","-","-","-","-","-","-","-","-","-","-","-","-","-","-","-"
"20 Nov 2024 19:45:21","Close Bet","O2-DB-9CLBV2","T2-DB-5NWNXH","O2-DB-9CLBQD","US NDAQ 100 - Cash","-","1","20,537.95","-","-","-","-","20,537.95","4.08","100,197.12","-","-","-","-","-","-","-","-","-","-","-","-","-","-","-","-","-","-","-","-","-","-","-","-","-"
"20 Nov 2024 19:38:17","Close Bet","O2-DB-9CLBDY","T2-DB-5NWNJG","O2-DB-9CL9ZR","Crude Oil West Texas - Jan 2025","-","2","68.838","-","-","-","-","13,767.60","15.00","100,193.04","-","-","-","-","-","-","-","-","-","-","-","-","-","-","-","-","-","-","-","-","-","-","-","-","-"
"20 Nov 2024 19:37:19","Close Bet","O2-DB-9CLBC5","T2-DB-5NWNH6","O2-DB-9CL9ZG","Crude Oil West Texas - Jan 2025","-","0.5","68.868","-","-","-","-","3,443.40","4.75","100,178.04","-","-","-","-","-","-","-","-","-","-","-","-","-","-","-","-","-","-","-","-","-","-","-","-","-"
"20 Nov 2024 19:35:11","Close Bet","O2-DB-9CLB78","T2-DB-5NWNED","O2-DB-9CL9ZG","Crude Oil West Texas - Jan 2025","-","0.5","68.848","-","-","-","-","3,442.40","3.75","100,173.29","-","-","-","-","-","-","-","-","-","-","-","-","-","-","-","-","-","-","-","-","-","-","-","-","-"
"20 Nov 2024 19:28:37","Close Bet","O2-DB-9CL9ZG","T2-DB-5NWN7V","O2-DB-9CL9YM","Crude Oil West Texas - Jan 2025","-","0.5","68.773","-","-","-","-","3,438.65","-4.75","100,169.54","-","-","-","-","-","-","-","-","-","-","-","-","-","-","-","-","-","-","-","-","-","-","-","-","-"
"20 Nov 2024 19:28:37","Close Bet","O2-DB-9CL9ZG","T2-DB-5NWN7T","O2-DB-9CL9XT","Crude Oil West Texas - Jan 2025","-","1.5","68.773","-","-","-","-","10,315.95","-11.25","100,174.29","-","-","-","-","-","-","-","-","-","-","-","-","-","-","-","-","-","-","-","-","-","-","-","-","-"
"20 Nov 2024 19:24:22","Close Bet","O2-DB-9CL9T4","T2-DB-5NWN43","O2-DB-9CL9MF","Crude Oil West Texas - Jan 2025","-","1.5","68.703","-","-","-","-","10,305.45","-1.50","100,185.54","-","-","-","-","-","-","-","-","-","-","-","-","-","-","-","-","-","-","-","-","-","-","-","-","-"
"20 Nov 2024 19:20:25","Close Bet","O2-DB-9CL9LP","T2-DB-5NWN07","O2-DB-9CL9FF","Crude Oil West Texas - Jan 2025","-","0.5","68.688","-","-","-","-","3,434.40","-5.25","100,187.04","-","-","-","-","-","-","-","-","-","-","-","-","-","-","-","-","-","-","-","-","-","-","-","-","-"
"20 Nov 2024 19:15:51","Close Bet","O2-DB-9CL9F1","T2-DB-5NWMW2","O2-DB-9CL9CW","Crude Oil West Texas - Jan 2025","-","1.5","68.748","-","-","-","-","10,312.20","6.00","100,192.29","-","-","-","-","-","-","-","-","-","-","-","-","-","-","-","-","-","-","-","-","-","-","-","-","-"
"20 Nov 2024 19:12:27","Close Bet","O2-DB-9CL9BM","T2-DB-5NWMSV","O2-DB-9CL94Y","Crude Oil West Texas - Jan 2025","-","2","68.728","-","-","-","-","13,745.60","-10.00","100,186.29","-","-","-","-","-","-","-","-","-","-","-","-","-","-","-","-","-","-","-","-","-","-","-","-","-"
"20 Nov 2024 19:07:35","Close Bet","O2-DB-9CL934","T2-DB-5NWMNM","O2-DB-9CL1VP","Crude Oil West Texas - Cash","-","0.5","69.008","-","-","-","-","3,450.40","-27.35","100,196.29","-","-","-","-","-","-","-","-","-","-","-","-","-","-","-","-","-","-","-","-","-","-","-","-","-"
"20 Nov 2024 19:07:13","Close Bet","O2-DB-9CL92M","T2-DB-5NWMN9","O2-DB-9CL8T6","Crude Oil West Texas - Jan 2025","-","1","68.763","-","-","-","-","6,876.30","0.50","100,223.64","-","-","-","-","-","-","-","-","-","-","-","-","-","-","-","-","-","-","-","-","-","-","-","-","-"
"20 Nov 2024 19:07:13","Close Bet","O2-DB-9CL92M","T2-DB-5NWMN8","O2-DB-9CL8T0","Crude Oil West Texas - Jan 2025","-","1","68.763","-","-","-","-","6,876.30","3.50","100,223.14","-","-","-","-","-","-","-","-","-","-","-","-","-","-","-","-","-","-","-","-","-","-","-","-","-"
"20 Nov 2024 18:21:38","Close Bet","O2-DB-9CL6V8","T2-DB-5NWL39","O2-DB-9CL6ES","Crude Oil West Texas - Jan 2025","-","1.5","68.833","-","-","-","-","10,324.95","0.75","100,219.64","-","-","-","-","-","-","-","-","-","-","-","-","-","-","-","-","-","-","-","-","-","-","-","-","-"
"20 Nov 2024 17:47:12","Close Bet","O2-DB-9CL4VR","T2-DB-5NWJMQ","O2-DB-9CL2ZE","US NDAQ 100 - Cash","-","0.1","20,560.54","-","-","-","-","2,056.05","-5.37","100,218.89","-","-","-","-","-","-","-","-","-","-","-","-","-","-","-","-","-","-","-","-","-","-","-","-","-"
"20 Nov 2024 17:23:54","Close Bet","O2-DB-9CL367","T2-DB-5NWHEK","O2-DB-9CK6HN","Gold - Cash","-","0.3","2,651.66","-","-","-","-","795.49","6.44","100,224.26","-","-","-","-","-","-","-","-","-","-","-","-","-","-","-","-","-","-","-","-","-","-","-","-","-"
"20 Nov 2024 17:17:29","Close Bet","O2-DB-9CL2JG","T2-DB-5NWGYF","O2-DB-9CL21B","US NDAQ 100 - Cash","-","0.1","20,533.84","-","-","-","-","2,053.38","-3.89","100,217.82","-","-","-","-","-","-","-","-","-","-","-","-","-","-","-","-","-","-","-","-","-","-","-","-","-"
"20 Nov 2024 17:15:33","Close Bet","O2-DB-9CL2D1","T2-DB-5NWGSY","O2-DB-9CKQKZ","Gasoline - Cash","-","0.5","2.0520","-","-","-","-","1,026.00","-9.15","100,221.71","-","-","-","-","-","-","-","-","-","-","-","-","-","-","-","-","-","-","-","-","-","-","-","-","-"
"20 Nov 2024 17:08:27","Close Bet","O2-DB-9CL1VV","T2-DB-5NWGDP","O2-DB-9CK3BY","USD/CAD","-","0.1","1.39960","-","-","-","-","1,399.60","-0.04","100,230.86","-","-","-","-","-","-","-","-","-","-","-","-","-","-","-","-","-","-","-","-","-","-","-","-","-"
"20 Nov 2024 17:02:29","Close Bet","O2-DB-9CL1B7","T2-DB-5NWFXN","O2-DB-9CKRM2","Heating Oil - Cash","-","0.5","2.2272","-","-","-","-","1,113.60","-2.75","100,230.90","-","-","-","-","-","-","-","-","-","-","-","-","-","-","-","-","-","-","-","-","-","-","-","-","-"
"20 Nov 2024 17:02:29","Close Bet","O2-DB-9CL1B7","T2-DB-5NWFXM","O2-DB-9CKQKC","Heating Oil - Cash","-","0.5","2.2272","-","-","-","-","1,113.60","2.70","100,233.65","-","-","-","-","-","-","-","-","-","-","-","-","-","-","-","-","-","-","-","-","-","-","-","-","-"
"20 Nov 2024 16:56:27","Close Bet","O2-DB-9CL0X4","T2-DB-5NWFKW","O2-DB-9CKZQ8","US NDAQ 100 - Cash","-","2.5","20,615.11","-","-","-","-","51,537.77","164.78","100,230.95","-","-","-","-","-","-","-","-","-","-","-","-","-","-","-","-","-","-","-","-","-","-","-","-","-"
"20 Nov 2024 16:44:17","Close Bet","O2-DB-9CKZP2","T2-DB-5NWEHC","O2-DB-9CKZF6","US NDAQ 100 - Cash","-","0.5","20,542.68","-","-","-","-","10,271.34","-8.36","100,066.17","-","-","-","-","-","-","-","-","-","-","-","-","-","-","-","-","-","-","-","-","-","-","-","-","-"
"20 Nov 2024 16:44:17","Close Bet","O2-DB-9CKZP2","T2-DB-5NWEHB","O2-DB-9CKZD9","US NDAQ 100 - Cash","-","0.5","20,542.68","-","-","-","-","10,271.34","-10.98","100,074.53","-","-","-","-","-","-","-","-","-","-","-","-","-","-","-","-","-","-","-","-","-","-","-","-","-"
"20 Nov 2024 16:44:17","Close Bet","O2-DB-9CKZP2","T2-DB-5NWEH9","O2-DB-9CKZ9E","US NDAQ 100 - Cash","-","0.5","20,542.68","-","-","-","-","10,271.34","-13.36","100,085.51","-","-","-","-","-","-","-","-","-","-","-","-","-","-","-","-","-","-","-","-","-","-","-","-","-"
"20 Nov 2024 16:44:17","Close Bet","O2-DB-9CKZP2","T2-DB-5NWEH8","O2-DB-9CKYWC","US NDAQ 100 - Cash","-","0.5","20,542.68","-","-","-","-","10,271.34","-29.73","100,098.87","-","-","-","-","-","-","-","-","-","-","-","-","-","-","-","-","-","-","-","-","-","-","-","-","-"
"20 Nov 2024 16:44:17","Close Bet","O2-DB-9CKZP2","T2-DB-5NWEH7","O2-DB-9CKYLE","US NDAQ 100 - Cash","-","0.5","20,542.68","-","-","-","-","10,271.34","-39.34","100,128.60","-","-","-","-","-","-","-","-","-","-","-","-","-","-","-","-","-","-","-","-","-","-","-","-","-"
"20 Nov 2024 16:40:45","Close Bet","O2-DB-9CKZDX","T2-DB-5NWE6X","O2-DB-9CKZC2","US NDAQ 100 - Cash","-","0.5","20,519.48","-","-","-","-","10,259.74","3.44","100,167.94","-","-","-","-","-","-","-","-","-","-","-","-","-","-","-","-","-","-","-","-","-","-","-","-","-"
"20 Nov 2024 16:27:26","Close Bet","O2-DB-9CKY6Q","T2-DB-5NWD8S","O2-DB-9CKWTS","US 30 - Cash","-","1","43,145.19","-","-","-","-","43,145.19","11.33","100,164.50","-","-","-","-","-","-","-","-","-","-","-","-","-","-","-","-","-","-","-","-","-","-","-","-","-"
"20 Nov 2024 16:27:02","Close Bet","O2-DB-9CKY4S","T2-DB-5NWD52","O2-DB-9CKY1Y","US NDAQ 100 - Cash","-","0.5","20,490.33","-","-","-","-","10,245.16","2.96","100,153.17","-","-","-","-","-","-","-","-","-","-","-","-","-","-","-","-","-","-","-","-","-","-","-","-","-"
"20 Nov 2024 16:25:35","Close Bet","O2-DB-9CKY0N","T2-DB-5NWD1V","O2-DB-9CKXP6","US NDAQ 100 - Cash","-","2","20,507.57","-","-","-","-","41,015.14","-1.04","100,150.21","-","-","-","-","-","-","-","-","-","-","-","-","-","-","-","-","-","-","-","-","-","-","-","-","-"
"20 Nov 2024 16:22:42","Close Bet","O2-DB-9CKXRP","T2-DB-5NWCVM","O2-DB-9CKRVE","Crude Oil West Texas - Cash","-","0.5","69.490","-","-","-","-","3,474.50","-12.30","100,151.25","-","-","-","-","-","-","-","-","-","-","-","-","-","-","-","-","-","-","-","-","-","-","-","-","-"
"20 Nov 2024 16:21:08","Close Bet","O2-DB-9CKXN3","T2-DB-5NWCSK","O2-DB-9CKXKQ","US NDAQ 100 - Cash","-","2","20,509.76","-","-","-","-","41,019.52","-14.44","100,163.55","-","-","-","-","-","-","-","-","-","-","-","-","-","-","-","-","-","-","-","-","-","-","-","-","-"
"20 Nov 2024 16:19:59","Close Bet","O2-DB-9CKXH4","T2-DB-5NWCP0","O2-DB-9CKXGS","US NDAQ 100 - Cash","-","1.5","20,508.82","-","-","-","-","30,763.23","-15.65","100,177.99","-","-","-","-","-","-","-","-","-","-","-","-","-","-","-","-","-","-","-","-","-","-","-","-","-"
"20 Nov 2024 16:11:39","Close Bet","O2-DB-9CKWQH","T2-DB-5NWC2Z","O2-DB-9CKWNW","US 30 - Cash","-","1","43,150.09","-","-","-","-","43,150.09","11.15","100,193.64","-","-","-","-","-","-","-","-","-","-","-","-","-","-","-","-","-","-","-","-","-","-","-","-","-"
"20 Nov 2024 16:10:22","Close Bet","O2-DB-9CKWJR","T2-DB-5NWBXN","O2-DB-9CKWBE","US 30 - Cash","-","0.5","43,203.16","-","-","-","-","21,601.58","-12.95","100,182.49","-","-","-","-","-","-","-","-","-","-","-","-","-","-","-","-","-","-","-","-","-","-","-","-","-"
"20 Nov 2024 15:59:53","Close Bet","O2-DB-9CKV4W","T2-DB-5NW9QE","O2-DB-9CKSYE","USD/JPY","-","0.5","155.528","-","-","-","-","7,776.40","6.15","100,195.44","-","-","-","-","-","-","-","-","-","-","-","-","-","-","-","-","-","-","-","-","-","-","-","-","-"
"20 Nov 2024 15:57:54","Close Bet","O2-DB-9CKTWY","T2-DB-5NW9GZ","O2-DB-9CKT84","US NDAQ 100 - Cash","-","0.3","20,530.59","-","-","-","-","6,159.17","-0.55","100,189.29","-","-","-","-","-","-","-","-","-","-","-","-","-","-","-","-","-","-","-","-","-","-","-","-","-"
"20 Nov 2024 15:48:31","Close Bet","O2-DB-9CKSVF","T2-DB-5NW8QX","O2-DB-9CKSLV","US NDAQ 100 - Cash","-","0.2","20,528.42","-","-","-","-","4,105.68","-0.22","100,189.84","-","-","-","-","-","-","-","-","-","-","-","-","-","-","-","-","-","-","-","-","-","-","-","-","-"
"20 Nov 2024 15:40:46","Close Bet","O2-DB-9CKRW7","T2-DB-5NW7ZZ","O2-DB-9CKPTE","US 30 - Cash","-","0.1","43,217.08","-","-","-","-","4,321.70","6.41","100,190.06","-","-","-","-","-","-","-","-","-","-","-","-","-","-","-","-","-","-","-","-","-","-","-","-","-"
"20 Nov 2024 15:40:46","Close Bet","O2-DB-9CKRW7","T2-DB-5NW7ZY","O2-DB-9CKMDB","US 30 - Cash","-","0.1","43,217.08","-","-","-","-","4,321.70","9.69","100,183.65","-","-","-","-","-","-","-","-","-","-","-","-","-","-","-","-","-","-","-","-","-","-","-","-","-"
"20 Nov 2024 15:39:41","Close Bet","O2-DB-9CKRQN","T2-DB-5NW7VT","O2-DB-9CKKG1","US T-Note 10 YR - Cash","-","0.3","109.493","-","-","-","-","3,284.79","0.69","100,173.96","-","-","-","-","-","-","-","-","-","-","-","-","-","-","-","-","-","-","-","-","-","-","-","-","-"
"20 Nov 2024 15:39:41","Close Bet","O2-DB-9CKRQN","T2-DB-5NW7VS","O2-DB-9CK9VR","US T-Note 10 YR - Cash","-","0.2","109.493","-","-","-","-","2,189.86","2.64","100,173.27","-","-","-","-","-","-","-","-","-","-","-","-","-","-","-","-","-","-","-","-","-","-","-","-","-"
"20 Nov 2024 15:39:41","Close Bet","O2-DB-9CKRQN","T2-DB-5NW7VR","O2-DB-9CJ9ET","US T-Note 10 YR - Cash","-","0.5","109.493","-","-","-","-","5,474.65","0.65","100,170.63","-","-","-","-","-","-","-","-","-","-","-","-","-","-","-","-","-","-","-","-","-","-","-","-","-"
"20 Nov 2024 15:34:53","Close Bet","O2-DB-9CKR5F","T2-DB-5NW7EW","O2-DB-9CKPHK","US NDAQ 100 - Cash","-","0.1","20,479.22","-","-","-","-","2,047.92","5.53","100,169.98","-","-","-","-","-","-","-","-","-","-","-","-","-","-","-","-","-","-","-","-","-","-","-","-","-"
"20 Nov 2024 15:34:53","Close Bet","O2-DB-9CKR5F","T2-DB-5NW7EV","O2-DB-9CKPFD","US NDAQ 100 - Cash","-","0.2","20,479.22","-","-","-","-","4,095.84","10.98","100,164.45","-","-","-","-","-","-","-","-","-","-","-","-","-","-","-","-","-","-","-","-","-","-","-","-","-"
"20 Nov 2024 15:34:53","Close Bet","O2-DB-9CKR5F","T2-DB-5NW7ET","O2-DB-9CKPCK","US NDAQ 100 - Cash","-","0.2","20,479.22","-","-","-","-","4,095.84","11.19","100,153.47","-","-","-","-","-","-","-","-","-","-","-","-","-","-","-","-","-","-","-","-","-","-","-","-","-"
"20 Nov 2024 15:34:53","Close Bet","O2-DB-9CKR5F","T2-DB-5NW7ES","O2-DB-9CKP9E","US NDAQ 100 - Cash","-","0.2","20,479.22","-","-","-","-","4,095.84","10.85","100,142.28","-","-","-","-","-","-","-","-","-","-","-","-","-","-","-","-","-","-","-","-","-","-","-","-","-"
"20 Nov 2024 15:34:53","Close Bet","O2-DB-9CKR5F","T2-DB-5NW7ER","O2-DB-9CKMP2","US NDAQ 100 - Cash","-","0.1","20,479.22","-","-","-","-","2,047.92","3.40","100,131.43","-","-","-","-","-","-","-","-","-","-","-","-","-","-","-","-","-","-","-","-","-","-","-","-","-"
"20 Nov 2024 15:22:48","Close Bet","O2-DB-9CKPDG","T2-DB-5NW5ZR","O2-DB-9CKLTB","US NDAQ 100 - Cash","-","0.1","20,420.31","-","-","-","-","2,042.03","-6.79","100,128.03","-","-","-","-","-","-","-","-","-","-","-","-","-","-","-","-","-","-","-","-","-","-","-","-","-"
"20 Nov 2024 15:22:48","Close Bet","O2-DB-9CKPDG","T2-DB-5NW5ZQ","O2-DB-9CKKV9","US NDAQ 100 - Cash","-","0.1","20,420.31","-","-","-","-","2,042.03","-11.79","100,134.82","-","-","-","-","-","-","-","-","-","-","-","-","-","-","-","-","-","-","-","-","-","-","-","-","-"
"20 Nov 2024 15:20:12","Close Bet","O2-DB-9CKNYW","T2-DB-5NW5MC","O2-DB-9CKGSH","US NDAQ 100 - Cash","-","0.5","20,423.17","-","-","-","-","10,211.58","-78.75","100,146.61","-","-","-","-","-","-","-","-","-","-","-","-","-","-","-","-","-","-","-","-","-","-","-","-","-"
"20 Nov 2024 15:17:34","Close Bet","O2-DB-9CKNLG","T2-DB-5NW5DE","O2-DB-9CKM0G","US NDAQ 100 - Cash","-","0.1","20,423.49","-","-","-","-","2,042.34","-5.37","100,225.36","-","-","-","-","-","-","-","-","-","-","-","-","-","-","-","-","-","-","-","-","-","-","-","-","-"
"20 Nov 2024 14:47:24","Close Bet","O2-DB-9CKJ5P","T2-DB-5NW1JE","O2-DB-9CKGNT","US 30 - Cash","-","0.5","43,275.97","-","-","-","-","21,637.98","41.74","100,230.73","-","-","-","-","-","-","-","-","-","-","-","-","-","-","-","-","-","-","-","-","-","-","-","-","-"
"20 Nov 2024 14:10:32","Close Bet","O2-DB-9CKCQ9","T2-DB-5NVWTL","O2-DB-9CKBZ9","Crude Oil West Texas - Cash","-","0.5","70.010","-","-","-","-","3,500.50","-2.50","100,188.99","-","-","-","-","-","-","-","-","-","-","-","-","-","-","-","-","-","-","-","-","-","-","-","-","-"
"20 Nov 2024 13:24:08","Close Bet","O2-DB-9CK9LS","T2-DB-5NVV7J","O2-DB-9CK6YQ","US 30 - Cash","-","1","43,411.29","-","-","-","-","43,411.29","42.83","100,191.49","-","-","-","-","-","-","-","-","-","-","-","-","-","-","-","-","-","-","-","-","-","-","-","-","-"
"20 Nov 2024 13:15:36","Close Bet","O2-DB-9CK98F","T2-DB-5NVTZ4","O2-DB-9CJXJB","Crude Oil West Texas - Cash","-","1","70.020","-","-","-","-","7,002.00","3.10","100,148.66","-","-","-","-","-","-","-","-","-","-","-","-","-","-","-","-","-","-","-","-","-","-","-","-","-"
"20 Nov 2024 13:15:03","Close Bet","O2-DB-9CK97G","T2-DB-5NVTYK","O2-DB-9CJBK6","Japan 225 - Cash","-","0.1","38,370.08","-","-","-","-","3,837.00","6.34","100,145.56","-","-","-","-","-","-","-","-","-","-","-","-","-","-","-","-","-","-","-","-","-","-","-","-","-"
"20 Nov 2024 12:13:56","Close Bet","O2-DB-9CK6M3","T2-DB-5NVRYX","O2-DB-9CK6FZ","Crude Oil West Texas - Jan 2025","-","1","69.643","-","-","-","-","6,964.30","-11.50","100,139.22","-","-","-","-","-","-","-","-","-","-","-","-","-","-","-","-","-","-","-","-","-","-","-","-","-"
"20 Nov 2024 12:03:47","Close Bet","O2-DB-9CK64W","T2-DB-5NVRJP","O2-DB-9CK3NT","Gold - Cash","-","10","2,628.77","-","-","-","-","26,287.70","35.90","100,150.72","-","-","-","-","-","-","-","-","-","-","-","-","-","-","-","-","-","-","-","-","-","-","-","-","-"
"20 Nov 2024 12:03:47","Close Bet","O2-DB-9CK64W","T2-DB-5NVRJN","O2-DB-9CK3CZ","Gold - Cash","-","0.1","2,628.77","-","-","-","-","262.87","0.46","100,114.82","-","-","-","-","-","-","-","-","-","-","-","-","-","-","-","-","-","-","-","-","-","-","-","-","-"
"20 Nov 2024 12:00:09","Close Bet","O2-DB-9CK5XP","T2-DB-5NVRDD","O2-DB-9CK3GN","GBP/JPY","-","1","197.380","-","-","-","-","19,738.00","-18.80","100,114.36","-","-","-","-","-","-","-","-","-","-","-","-","-","-","-","-","-","-","-","-","-","-","-","-","-"
"20 Nov 2024 11:56:44","Close Bet","O2-DB-9CK5S5","T2-DB-5NVR9F","O2-DB-9CK5J9","Crude Oil West Texas - Jan 2025","-","1","69.633","-","-","-","-","6,963.30","-19.00","100,133.16","-","-","-","-","-","-","-","-","-","-","-","-","-","-","-","-","-","-","-","-","-","-","-","-","-"
"20 Nov 2024 08:26:28","Close Bet","O2-DB-9CJVPW","T2-DB-5NVHZC","O2-DB-9CJBN6","USD/JPY","-","0.5","155.632","-","-","-","-","7,781.60","50.75","100,152.16","-","-","-","-","-","-","-","-","-","-","-","-","-","-","-","-","-","-","-","-","-","-","-","-","-"
"19 Nov 2024 23:11:01","Close Bet","O2-DB-9CJB8T","T2-DB-5NV5SF","O2-DB-9CJB82","USD/CAD","-","0.3","1.39553","-","-","-","-","4,186.59","-0.39","10,101.41","-","-","-","-","-","-","-","-","-","-","-","-","-","-","-","-","-","-","-","-","-","-","-","-","-"
"19 Nov 2024 12:04:26","Close Bet","O2-DB-9CGXNG","T2-DB-5NT4VS","O2-DB-9CETZ6","Crude Oil West Texas - Cash","-","0.5","68.975","-","-","-","-","3,448.75","51.30","10,101.80","-","-","-","-","-","-","-","-","-","-","-","-","-","-","-","-","-","-","-","-","-","-","-","-","-"
"19 Nov 2024 09:27:35","Stop Loss","O2-DB-9CF6Z8","T2-DB-5NSWBE","-","AUD/USD","-","0.3","0.64870","-","-","-","-","1,946.10","0.99","10,050.50","-","-","-","-","-","-","-","-","-","-","-","-","-","-","-","-","-","-","-","-","-","-","-","-","-"
"18 Nov 2024 15:29:06","Close Bet","O2-DB-9CF3QC","T2-DB-5NRSL5","O2-DB-9CBZH3","Gold - Cash","-","1.5","2,610.91","-","-","-","-","3,916.36","58.25","10,049.43","-","-","-","-","-","-","-","-","-","-","-","-","-","-","-","-","-","-","-","-","-","-","-","-","-"
"18 Nov 2024 14:16:43","Close Bet","O2-DB-9CEVFM","T2-DB-5NRL02","O2-DB-9CB050","US 30 - Cash","-","0.1","43,386.43","-","-","-","-","4,338.64","33.51","9,991.18","-","-","-","-","-","-","-","-","-","-","-","-","-","-","-","-","-","-","-","-","-","-","-","-","-"
"15 Nov 2024 17:27:48","Take Profit","O2-DB-9CBMZV","T2-DB-5NQ80Z","-","USD/JPY","-","0.5","154.450","-","-","-","-","7,722.50","49.65","9,960.11","-","-","-","-","-","-","-","-","-","-","-","-","-","-","-","-","-","-","-","-","-","-","-","-","-"
"15 Nov 2024 16:51:30","Stop Loss","O2-DB-9CBZLW","T2-DB-5NQ5MV","-","Crude Oil West Texas - Cash","-","0.5","67.800","-","-","-","-","3,390.00","-34.90","9,910.46","-","-","-","-","-","-","-","-","-","-","-","-","-","-","-","-","-","-","-","-","-","-","-","-","-"
"15 Nov 2024 07:23:35","Stop Loss","O2-DB-9C9MKD","T2-DB-5NP2CR","-","Crude Oil West Texas - Cash","-","0.5","67.830","-","-","-","-","3,391.50","-54.80","9,945.36","-","-","-","-","-","-","-","-","-","-","-","-","-","-","-","-","-","-","-","-","-","-","-","-","-"